,id,expiration_id,src_ip,src_mac,src_oui,src_port,dst_ip,dst_mac,dst_oui,dst_port,protocol,ip_version,vlan_id,tunnel_id,bidirectional_first_seen_ms,bidirectional_last_seen_ms,bidirectional_duration_ms,bidirectional_packets,bidirectional_bytes,src2dst_first_seen_ms,src2dst_last_seen_ms,src2dst_duration_ms,src2dst_packets,src2dst_bytes,dst2src_first_seen_ms,dst2src_last_seen_ms,dst2src_duration_ms,dst2src_packets,dst2src_bytes,application_name,application_category_name,application_is_guessed,application_confidence,requested_server_name,client_fingerprint,server_fingerprint,user_agent,content_type
0,0,0,fe80::da58:d7ff:fe00:f72,d8:58:d7:00:0f:72,d8:58:d7,0,ff02::1,33:33:00:00:00:01,33:33:00,0,58,6,0,0,10833,12840,2007,2,172,10833,12840,2007,2,172,0,0,0,0,0,ICMPV6,Network,0,6,,,,,
1,1,0,::,08:00:27:38:31:62,08:00:27,0,ff02::1:ff7f:abb3,33:33:ff:7f:ab:b3,33:33:ff,0,58,6,0,0,10209,10209,0,2,156,10209,10209,0,2,156,0,0,0,0,0,ICMPV6,Network,0,6,,,,,
2,2,0,::,08:00:27:38:31:62,08:00:27,0,ff02::1:ff62:aec8,33:33:ff:62:ae:c8,33:33:ff,0,58,6,0,0,10210,10210,0,1,78,10210,10210,0,1,78,0,0,0,0,0,ICMPV6,Network,0,6,,,,,
3,3,0,::,08:00:27:38:31:62,08:00:27,0,ff02::1:ff00:2c6,33:33:ff:00:02:c6,33:33:ff,0,58,6,0,0,10210,10210,0,1,78,10210,10210,0,1,78,0,0,0,0,0,ICMPV6,Network,0,6,,,,,
4,4,0,fe80::e8ff:97da:2f7f:abb3,08:00:27:38:31:62,08:00:27,0,ff02::2,33:33:00:00:00:02,33:33:00,0,58,6,0,0,10210,18211,8001,4,296,10210,18211,8001,4,296,0,0,0,0,0,ICMPV6,Network,0,6,,,,,
5,5,0,fe80::e8ff:97da:2f7f:abb3,08:00:27:38:31:62,08:00:27,0,ff02::1:ff7f:abb3,33:33:ff:7f:ab:b3,33:33:ff,0,58,6,0,0,10210,15707,5497,3,258,10210,15707,5497,3,258,0,0,0,0,0,ICMPV6,Network,0,6,,,,,
6,6,0,fe80::f106:5909:32ae:f4cb,08:00:27:11:4e:fa,08:00:27,0,ff02::1:ffcc:1f02,33:33:ff:cc:1f:02,33:33:ff,0,58,6,0,0,17499,17499,0,1,86,17499,17499,0,1,86,0,0,0,0,0,ICMPV6,Network,0,6,,,,,
7,7,0,fe80::f106:5909:32ae:f4cb,08:00:27:11:4e:fa,08:00:27,0,ff02::1:ff00:4f7,33:33:ff:00:04:f7,33:33:ff,0,58,6,0,0,13002,13002,0,1,86,13002,13002,0,1,86,0,0,0,0,0,ICMPV6,Network,0,6,,,,,
8,8,0,fe80::5dd3:6bb3:7720:1e83,08:00:27:52:f4:11,08:00:27,0,ff02::1:ff2b:5398,33:33:ff:2b:53:98,33:33:ff,0,58,6,0,0,18538,18538,0,1,86,18538,18538,0,1,86,0,0,0,0,0,ICMPV6,Network,0,6,,,,,
9,9,0,fe80::5dd3:6bb3:7720:1e83,08:00:27:52:f4:11,08:00:27,0,ff02::1:ff20:1e83,33:33:ff:20:1e:83,33:33:ff,0,58,6,0,0,11538,17536,5998,2,172,11538,17536,5998,2,172,0,0,0,0,0,ICMPV6,Network,0,6,,,,,
10,10,0,fe80::5dd3:6bb3:7720:1e83,08:00:27:52:f4:11,08:00:27,0,ff02::1:ff00:2c6,33:33:ff:00:02:c6,33:33:ff,0,58,6,0,0,11037,21042,10005,2,172,11037,21042,10005,2,172,0,0,0,0,0,ICMPV6,Network,0,6,,,,,
11,11,0,fe80::e8ff:97da:2f7f:abb3,08:00:27:38:31:62,08:00:27,0,ff02::1:ff00:b30,33:33:ff:00:0b:30,33:33:ff,0,58,6,0,0,11875,17710,5835,3,258,11875,17710,5835,3,258,0,0,0,0,0,ICMPV6,Network,0,6,,,,,
12,12,0,0.0.0.0,d8:58:d7:00:0f:72,d8:58:d7,0,224.0.0.1,01:00:5e:00:00:01,01:00:5e,0,2,4,0,0,52553,52553,0,1,60,52553,52553,0,1,60,0,0,0,0,0,IGMP,Network,0,6,,,,,
13,13,0,fd2d:ab8c:225:0:81d3:fd3e:7f62:aec8,08:00:27:38:31:62,08:00:27,0,ff02::1:ff00:1,33:33:ff:00:00:01,33:33:ff,0,58,6,0,0,14970,14970,0,1,86,14970,14970,0,1,86,0,0,0,0,0,ICMPV6,Network,0,6,,,,,
14,14,0,fd2d:ab8c:225::1,d8:58:d7:00:0f:72,d8:58:d7,0,fd2d:ab8c:225:0:81d3:fd3e:7f62:aec8,08:00:27:38:31:62,08:00:27,0,58,6,0,0,14970,14970,0,1,86,14970,14970,0,1,86,0,0,0,0,0,ICMPV6,Network,0,6,,,,,
15,15,0,fe80::da58:d7ff:fe00:f72,d8:58:d7:00:0f:72,d8:58:d7,0,fd2d:ab8c:225:0:81d3:fd3e:7f62:aec8,08:00:27:38:31:62,08:00:27,0,58,6,0,0,19976,19976,0,2,172,19976,19976,0,1,86,19976,19976,0,1,86,ICMPV6,Network,0,6,,,,,
16,16,0,fe80::da58:d7ff:fe00:f72,d8:58:d7:00:0f:72,d8:58:d7,0,fe80::e8ff:97da:2f7f:abb3,08:00:27:38:31:62,08:00:27,0,58,6,0,0,10211,19713,9502,7,930,10211,19713,9502,5,758,15224,19713,4489,2,172,ICMPV6,Network,0,6,,,,,
17,17,0,fe80::e8ff:97da:2f7f:abb3,08:00:27:38:31:62,08:00:27,0,ff02::1:ff62:aec8,33:33:ff:62:ae:c8,33:33:ff,0,58,6,0,0,10210,140216,130006,4,344,10210,140216,130006,4,344,0,0,0,0,0,ICMPV6,Network,0,6,,,,,
18,18,0,fe80::e8ff:97da:2f7f:abb3,08:00:27:38:31:62,08:00:27,0,ff02::1:ff00:2c6,33:33:ff:00:02:c6,33:33:ff,0,58,6,0,0,10210,10710,500,2,172,10210,10710,500,2,172,0,0,0,0,0,ICMPV6,Network,0,6,,,,,
19,19,0,fd2d:ab8c:225::2c6,08:00:27:52:f4:11,08:00:27,0,ff02::1,33:33:00:00:00:01,33:33:00,0,58,6,0,0,10210,10210,0,1,86,10210,10210,0,1,86,0,0,0,0,0,ICMPV6,Network,0,6,,,,,
20,20,0,fe80::e8ff:97da:2f7f:abb3,08:00:27:38:31:62,08:00:27,546,ff02::1:2,33:33:00:01:00:02,33:33:00,547,17,6,0,0,10830,11872,1042,3,496,10830,11872,1042,3,496,0,0,0,0,0,DHCPV6,Network,0,6,,,,,
21,21,0,fe80::da58:d7ff:fe00:f72,d8:58:d7:00:0f:72,d8:58:d7,547,fe80::e8ff:97da:2f7f:abb3,08:00:27:38:31:62,08:00:27,546,17,6,0,0,10831,11873,1042,3,561,10831,11873,1042,3,561,0,0,0,0,0,DHCPV6,Network,0,6,,,,,
22,22,0,::,08:00:27:38:31:62,08:00:27,0,ff02::1:ff00:b30,33:33:ff:00:0b:30,33:33:ff,0,58,6,0,0,12212,12212,0,1,78,12212,12212,0,1,78,0,0,0,0,0,ICMPV6,Network,0,6,,,,,
23,23,0,fe80::f106:5909:32ae:f4cb,08:00:27:11:4e:fa,08:00:27,0,ff02::1:ffae:f4cb,33:33:ff:ae:f4:cb,33:33:ff,0,58,6,0,0,12502,138493,125991,3,258,12502,138493,125991,3,258,0,0,0,0,0,ICMPV6,Network,0,6,,,,,
26,26,0,fe80::da58:d7ff:fe00:f72,d8:58:d7:00:0f:72,d8:58:d7,0,ff02::1,33:33:00:00:00:01,33:33:00,0,58,6,0,0,138055,138055,0,1,86,138055,138055,0,1,86,0,0,0,0,0,ICMPV6,Network,0,6,,,,,
27,27,0,fe80::5dd3:6bb3:7720:1e83,08:00:27:52:f4:11,08:00:27,0,ff02::1:ff2b:5398,33:33:ff:2b:53:98,33:33:ff,0,58,6,0,0,139041,139041,0,1,86,139041,139041,0,1,86,0,0,0,0,0,ICMPV6,Network,0,6,,,,,
28,28,0,fe80::5dd3:6bb3:7720:1e83,08:00:27:52:f4:11,08:00:27,0,ff02::1:ff00:2c6,33:33:ff:00:02:c6,33:33:ff,0,58,6,0,0,144539,144539,0,1,86,144539,144539,0,1,86,0,0,0,0,0,ICMPV6,Network,0,6,,,,,
29,29,0,fe80::f106:5909:32ae:f4cb,08:00:27:11:4e:fa,08:00:27,0,ff02::1:ff00:4f7,33:33:ff:00:04:f7,33:33:ff,0,58,6,0,0,138493,138493,0,1,86,138493,138493,0,1,86,0,0,0,0,0,ICMPV6,Network,0,6,,,,,
30,30,0,fe80::e8ff:97da:2f7f:abb3,08:00:27:38:31:62,08:00:27,0,ff02::1:ff00:b30,33:33:ff:00:0b:30,33:33:ff,0,58,6,0,0,146215,146215,0,1,86,146215,146215,0,1,86,0,0,0,0,0,ICMPV6,Network,0,6,,,,,
31,31,0,fe80::5dd3:6bb3:7720:1e83,08:00:27:52:f4:11,08:00:27,0,ff02::1:ff20:1e83,33:33:ff:20:1e:83,33:33:ff,0,58,6,0,0,141535,141535,0,1,86,141535,141535,0,1,86,0,0,0,0,0,ICMPV6,Network,0,6,,,,,
32,32,0,fe80::f106:5909:32ae:f4cb,08:00:27:11:4e:fa,08:00:27,0,ff02::1:ffcc:1f02,33:33:ff:cc:1f:02,33:33:ff,0,58,6,0,0,138493,138493,0,1,86,138493,138493,0,1,86,0,0,0,0,0,ICMPV6,Network,0,6,,,,,
33,33,0,fe80::e8ff:97da:2f7f:abb3,08:00:27:38:31:62,08:00:27,0,ff02::1:ff7f:abb3,33:33:ff:7f:ab:b3,33:33:ff,0,58,6,0,0,141708,141708,0,1,86,141708,141708,0,1,86,0,0,0,0,0,ICMPV6,Network,0,6,,,,,
34,34,0,0.0.0.0,d8:58:d7:00:0f:72,d8:58:d7,0,224.0.0.1,01:00:5e:00:00:01,01:00:5e,0,2,4,0,0,177991,177991,0,1,60,177991,177991,0,1,60,0,0,0,0,0,IGMP,Network,0,6,,,,,
35,35,0,fe80::da58:d7ff:fe00:f72,d8:58:d7:00:0f:72,d8:58:d7,0,ff02::1,33:33:00:00:00:01,33:33:00,0,58,6,0,0,263495,263495,0,1,86,263495,263495,0,1,86,0,0,0,0,0,ICMPV6,Network,0,6,,,,,
36,36,0,fe80::e8ff:97da:2f7f:abb3,08:00:27:38:31:62,08:00:27,0,ff02::1:ff62:aec8,33:33:ff:62:ae:c8,33:33:ff,0,58,6,0,0,267709,267709,0,1,86,267709,267709,0,1,86,0,0,0,0,0,ICMPV6,Network,0,6,,,,,
37,37,0,fe80::5dd3:6bb3:7720:1e83,08:00:27:52:f4:11,08:00:27,0,ff02::1:ff20:1e83,33:33:ff:20:1e:83,33:33:ff,0,58,6,0,0,269039,269039,0,1,86,269039,269039,0,1,86,0,0,0,0,0,ICMPV6,Network,0,6,,,,,
38,38,0,fe80::5dd3:6bb3:7720:1e83,08:00:27:52:f4:11,08:00:27,0,ff02::1:ff00:2c6,33:33:ff:00:02:c6,33:33:ff,0,58,6,0,0,265544,265544,0,1,86,265544,265544,0,1,86,0,0,0,0,0,ICMPV6,Network,0,6,,,,,
39,39,0,fe80::5dd3:6bb3:7720:1e83,08:00:27:52:f4:11,08:00:27,0,ff02::1:ff2b:5398,33:33:ff:2b:53:98,33:33:ff,0,58,6,0,0,263541,263541,0,1,86,263541,263541,0,1,86,0,0,0,0,0,ICMPV6,Network,0,6,,,,,
40,40,0,fe80::f106:5909:32ae:f4cb,08:00:27:11:4e:fa,08:00:27,0,ff02::1:ff00:4f7,33:33:ff:00:04:f7,33:33:ff,0,58,6,0,0,266497,266497,0,1,86,266497,266497,0,1,86,0,0,0,0,0,ICMPV6,Network,0,6,,,,,
41,41,0,fe80::e8ff:97da:2f7f:abb3,08:00:27:38:31:62,08:00:27,0,ff02::1:ff00:b30,33:33:ff:00:0b:30,33:33:ff,0,58,6,0,0,267710,267710,0,1,86,267710,267710,0,1,86,0,0,0,0,0,ICMPV6,Network,0,6,,,,,
42,42,0,fe80::f106:5909:32ae:f4cb,08:00:27:11:4e:fa,08:00:27,0,ff02::1:ffae:f4cb,33:33:ff:ae:f4:cb,33:33:ff,0,58,6,0,0,269501,269501,0,1,86,269501,269501,0,1,86,0,0,0,0,0,ICMPV6,Network,0,6,,,,,
43,43,0,0.0.0.0,d8:58:d7:00:0f:72,d8:58:d7,0,224.0.0.1,01:00:5e:00:00:01,01:00:5e,0,2,4,0,0,303430,303430,0,1,60,303430,303430,0,1,60,0,0,0,0,0,IGMP,Network,0,6,,,,,
48,48,0,fe80::da58:d7ff:fe00:f72,d8:58:d7:00:0f:72,d8:58:d7,0,ff02::1,33:33:00:00:00:01,33:33:00,0,58,6,0,0,388934,390744,1810,2,284,388934,390744,1810,2,284,0,0,0,0,0,ICMPV6,Network,0,6,,,,,
49,49,0,fe80::5dd3:6bb3:7720:1e83,08:00:27:52:f4:11,08:00:27,0,ff02::1:ff00:2c6,33:33:ff:00:02:c6,33:33:ff,0,58,6,0,0,392036,392036,0,1,86,392036,392036,0,1,86,0,0,0,0,0,ICMPV6,Network,0,6,,,,,
50,50,0,fe80::5dd3:6bb3:7720:1e83,08:00:27:52:f4:11,08:00:27,0,ff02::1:ff20:1e83,33:33:ff:20:1e:83,33:33:ff,0,58,6,0,0,390043,390043,0,1,86,390043,390043,0,1,86,0,0,0,0,0,ICMPV6,Network,0,6,,,,,
51,51,0,fe80::f106:5909:32ae:f4cb,08:00:27:11:4e:fa,08:00:27,0,ff02::1:ff00:4f7,33:33:ff:00:04:f7,33:33:ff,0,58,6,0,0,395002,395002,0,1,86,395002,395002,0,1,86,0,0,0,0,0,ICMPV6,Network,0,6,,,,,
52,52,0,fe80::e8ff:97da:2f7f:abb3,08:00:27:38:31:62,08:00:27,0,ff02::1:ff00:b30,33:33:ff:00:0b:30,33:33:ff,0,58,6,0,0,395212,395212,0,1,86,395212,395212,0,1,86,0,0,0,0,0,ICMPV6,Network,0,6,,,,,
53,53,0,fe80::e8ff:97da:2f7f:abb3,08:00:27:38:31:62,08:00:27,0,ff02::1:ff62:aec8,33:33:ff:62:ae:c8,33:33:ff,0,58,6,0,0,389214,389214,0,1,86,389214,389214,0,1,86,0,0,0,0,0,ICMPV6,Network,0,6,,,,,
54,54,0,fe80::f106:5909:32ae:f4cb,08:00:27:11:4e:fa,08:00:27,0,ff02::1:ffcc:1f02,33:33:ff:cc:1f:02,33:33:ff,0,58,6,0,0,272496,388993,116497,2,172,272496,388993,116497,2,172,0,0,0,0,0,ICMPV6,Network,0,6,,,,,
55,55,0,fe80::e8ff:97da:2f7f:abb3,08:00:27:38:31:62,08:00:27,0,ff02::1:ff7f:abb3,33:33:ff:7f:ab:b3,33:33:ff,0,58,6,0,0,273207,391207,118000,2,172,273207,391207,118000,2,172,0,0,0,0,0,ICMPV6,Network,0,6,,,,,
56,56,0,fe80::5dd3:6bb3:7720:1e83,08:00:27:52:f4:11,08:00:27,0,ff02::1:ff2b:5398,33:33:ff:2b:53:98,33:33:ff,0,58,6,0,0,394540,394540,0,1,86,394540,394540,0,1,86,0,0,0,0,0,ICMPV6,Network,0,6,,,,,
57,57,0,0.0.0.0,d8:58:d7:00:0f:72,d8:58:d7,0,224.0.0.1,01:00:5e:00:00:01,01:00:5e,0,2,4,0,0,428870,428870,0,1,60,428870,428870,0,1,60,0,0,0,0,0,IGMP,Network,0,6,,,,,
59,59,0,fe80::e8ff:97da:2f7f:abb3,08:00:27:38:31:62,08:00:27,0,ff02::1:ff00:f72,33:33:ff:00:0f:72,33:33:ff,0,58,6,0,0,201143,201143,0,1,86,201143,201143,0,1,86,0,0,0,0,0,ICMPV6,Network,0,6,,,,,
61,61,0,fe80::da58:d7ff:fe00:f72,d8:58:d7:00:0f:72,d8:58:d7,0,ff02::1,33:33:00:00:00:01,33:33:00,0,58,6,0,0,514373,514373,0,1,86,514373,514373,0,1,86,0,0,0,0,0,ICMPV6,Network,0,6,,,,,
62,62,0,fe80::f106:5909:32ae:f4cb,08:00:27:11:4e:fa,08:00:27,0,ff02::1:ffae:f4cb,33:33:ff:ae:f4:cb,33:33:ff,0,58,6,0,0,397996,515495,117499,2,172,397996,515495,117499,2,172,0,0,0,0,0,ICMPV6,Network,0,6,,,,,
63,63,0,fe80::e8ff:97da:2f7f:abb3,08:00:27:38:31:62,08:00:27,0,ff02::1:ff00:b30,33:33:ff:00:0b:30,33:33:ff,0,58,6,0,0,517709,517709,0,1,86,517709,517709,0,1,86,0,0,0,0,0,ICMPV6,Network,0,6,,,,,
64,64,0,fe80::5dd3:6bb3:7720:1e83,08:00:27:52:f4:11,08:00:27,0,ff02::1:ff00:2c6,33:33:ff:00:02:c6,33:33:ff,0,58,6,0,0,515043,515043,0,1,86,515043,515043,0,1,86,0,0,0,0,0,ICMPV6,Network,0,6,,,,,
65,65,0,fe80::e8ff:97da:2f7f:abb3,08:00:27:38:31:62,08:00:27,0,ff02::1:ff7f:abb3,33:33:ff:7f:ab:b3,33:33:ff,0,58,6,0,0,522216,522216,0,1,86,522216,522216,0,1,86,0,0,0,0,0,ICMPV6,Network,0,6,,,,,
66,66,0,fe80::5dd3:6bb3:7720:1e83,08:00:27:52:f4:11,08:00:27,0,ff02::1:ff20:1e83,33:33:ff:20:1e:83,33:33:ff,0,58,6,0,0,517036,517036,0,1,86,517036,517036,0,1,86,0,0,0,0,0,ICMPV6,Network,0,6,,,,,
67,67,0,fe80::5dd3:6bb3:7720:1e83,08:00:27:52:f4:11,08:00:27,0,ff02::1:ff2b:5398,33:33:ff:2b:53:98,33:33:ff,0,58,6,0,0,522544,522544,0,1,86,522544,522544,0,1,86,0,0,0,0,0,ICMPV6,Network,0,6,,,,,
70,70,0,fe80::f106:5909:32ae:f4cb,08:00:27:11:4e:fa,08:00:27,0,ff02::1:ff00:4f7,33:33:ff:00:04:f7,33:33:ff,0,58,6,0,0,517498,517498,0,1,86,517498,517498,0,1,86,0,0,0,0,0,ICMPV6,Network,0,6,,,,,
71,71,0,fe80::e8ff:97da:2f7f:abb3,08:00:27:38:31:62,08:00:27,0,ff02::1:ff62:aec8,33:33:ff:62:ae:c8,33:33:ff,0,58,6,0,0,518210,518210,0,1,86,518210,518210,0,1,86,0,0,0,0,0,ICMPV6,Network,0,6,,,,,
72,72,0,fe80::f106:5909:32ae:f4cb,08:00:27:11:4e:fa,08:00:27,0,ff02::1:ffcc:1f02,33:33:ff:cc:1f:02,33:33:ff,0,58,6,0,0,519501,519501,0,1,86,519501,519501,0,1,86,0,0,0,0,0,ICMPV6,Network,0,6,,,,,
76,76,0,0.0.0.0,d8:58:d7:00:0f:72,d8:58:d7,0,224.0.0.1,01:00:5e:00:00:01,01:00:5e,0,2,4,0,0,554309,554309,0,1,60,554309,554309,0,1,60,0,0,0,0,0,IGMP,Network,0,6,,,,,
82,82,0,fe80::da58:d7ff:fe00:f72,d8:58:d7:00:0f:72,d8:58:d7,0,ff02::1,33:33:00:00:00:01,33:33:00,0,58,6,0,0,639448,639813,365,2,284,639448,639813,365,2,284,0,0,0,0,0,ICMPV6,Network,0,6,,,,,
83,83,0,fe80::5dd3:6bb3:7720:1e83,08:00:27:52:f4:11,08:00:27,0,ff02::1:ff2b:5398,33:33:ff:2b:53:98,33:33:ff,0,58,6,0,0,644039,644039,0,1,86,644039,644039,0,1,86,0,0,0,0,0,ICMPV6,Network,0,6,,,,,
84,84,0,fe80::e8ff:97da:2f7f:abb3,08:00:27:38:31:62,08:00:27,0,ff02::1:ff7f:abb3,33:33:ff:7f:ab:b3,33:33:ff,0,58,6,0,0,642709,642709,0,1,86,642709,642709,0,1,86,0,0,0,0,0,ICMPV6,Network,0,6,,,,,
85,85,0,fe80::e8ff:97da:2f7f:abb3,08:00:27:38:31:62,08:00:27,0,ff02::1:ff00:b30,33:33:ff:00:0b:30,33:33:ff,0,58,6,0,0,640215,640215,0,1,86,640215,640215,0,1,86,0,0,0,0,0,ICMPV6,Network,0,6,,,,,
86,86,0,fe80::5dd3:6bb3:7720:1e83,08:00:27:52:f4:11,08:00:27,0,ff02::1:ff00:2c6,33:33:ff:00:02:c6,33:33:ff,0,58,6,0,0,640543,640543,0,1,86,640543,640543,0,1,86,0,0,0,0,0,ICMPV6,Network,0,6,,,,,
87,87,0,fe80::f106:5909:32ae:f4cb,08:00:27:11:4e:fa,08:00:27,0,ff02::1:ffae:f4cb,33:33:ff:ae:f4:cb,33:33:ff,0,58,6,0,0,639994,639994,0,1,86,639994,639994,0,1,86,0,0,0,0,0,ICMPV6,Network,0,6,,,,,
89,89,0,fe80::5dd3:6bb3:7720:1e83,08:00:27:52:f4:11,08:00:27,0,ff02::1:ff20:1e83,33:33:ff:20:1e:83,33:33:ff,0,58,6,0,0,644039,644039,0,1,86,644039,644039,0,1,86,0,0,0,0,0,ICMPV6,Network,0,6,,,,,
91,91,0,fe80::f106:5909:32ae:f4cb,08:00:27:11:4e:fa,08:00:27,0,ff02::1:ffcc:1f02,33:33:ff:cc:1f:02,33:33:ff,0,58,6,0,0,648997,648997,0,1,86,648997,648997,0,1,86,0,0,0,0,0,ICMPV6,Network,0,6,,,,,
94,94,0,0.0.0.0,d8:58:d7:00:0f:72,d8:58:d7,0,224.0.0.1,01:00:5e:00:00:01,01:00:5e,0,2,4,0,0,679748,679748,0,1,60,679748,679748,0,1,60,0,0,0,0,0,IGMP,Network,0,6,,,,,
97,97,0,192.168.1.166,a4:5e:60:dd:58:1d,a4:5e:60,138,192.168.1.255,ff:ff:ff:ff:ff:ff,ff:ff:ff,138,17,4,0,0,279594,280205,611,3,648,279594,280205,611,3,648,0,0,0,0,0,NetBIOS.SMBv1,System,0,6,macbookpro-581d,,,,
99,99,0,fe80::da58:d7ff:fe00:f72,d8:58:d7:00:0f:72,d8:58:d7,0,ff02::1,33:33:00:00:00:01,33:33:00,0,58,6,0,0,765252,765252,0,1,86,765252,765252,0,1,86,0,0,0,0,0,ICMPV6,Network,0,6,,,,,
100,100,0,fe80::e8ff:97da:2f7f:abb3,08:00:27:38:31:62,08:00:27,0,ff02::1:ff62:aec8,33:33:ff:62:ae:c8,33:33:ff,0,58,6,0,0,648707,767207,118500,2,172,648707,767207,118500,2,172,0,0,0,0,0,ICMPV6,Network,0,6,,,,,
101,101,0,fe80::f106:5909:32ae:f4cb,08:00:27:11:4e:fa,08:00:27,0,ff02::1:ffae:f4cb,33:33:ff:ae:f4:cb,33:33:ff,0,58,6,0,0,769500,769500,0,1,86,769500,769500,0,1,86,0,0,0,0,0,ICMPV6,Network,0,6,,,,,
102,102,0,fe80::f106:5909:32ae:f4cb,08:00:27:11:4e:fa,08:00:27,0,ff02::1:ff00:4f7,33:33:ff:00:04:f7,33:33:ff,0,58,6,0,0,646493,765995,119502,2,172,646493,765995,119502,2,172,0,0,0,0,0,ICMPV6,Network,0,6,,,,,
103,103,0,fe80::5dd3:6bb3:7720:1e83,08:00:27:52:f4:11,08:00:27,0,ff02::1:ff00:2c6,33:33:ff:00:02:c6,33:33:ff,0,58,6,0,0,769038,769038,0,1,86,769038,769038,0,1,86,0,0,0,0,0,ICMPV6,Network,0,6,,,,,
104,104,0,fe80::e8ff:97da:2f7f:abb3,08:00:27:38:31:62,08:00:27,0,ff02::1:ff7f:abb3,33:33:ff:7f:ab:b3,33:33:ff,0,58,6,0,0,766707,766707,0,1,86,766707,766707,0,1,86,0,0,0,0,0,ICMPV6,Network,0,6,,,,,
105,105,0,fe80::f106:5909:32ae:f4cb,08:00:27:11:4e:fa,08:00:27,0,ff02::1:ffcc:1f02,33:33:ff:cc:1f:02,33:33:ff,0,58,6,0,0,773496,773496,0,1,86,773496,773496,0,1,86,0,0,0,0,0,ICMPV6,Network,0,6,,,,,
106,106,0,fe80::5dd3:6bb3:7720:1e83,08:00:27:52:f4:11,08:00:27,0,ff02::1:ff2b:5398,33:33:ff:2b:53:98,33:33:ff,0,58,6,0,0,765543,765543,0,1,86,765543,765543,0,1,86,0,0,0,0,0,ICMPV6,Network,0,6,,,,,
107,107,0,fe80::e8ff:97da:2f7f:abb3,08:00:27:38:31:62,08:00:27,0,ff02::1:ff00:b30,33:33:ff:00:0b:30,33:33:ff,0,58,6,0,0,768209,768209,0,1,86,768209,768209,0,1,86,0,0,0,0,0,ICMPV6,Network,0,6,,,,,
108,108,0,fe80::5dd3:6bb3:7720:1e83,08:00:27:52:f4:11,08:00:27,0,ff02::1:ff20:1e83,33:33:ff:20:1e:83,33:33:ff,0,58,6,0,0,770540,770540,0,1,86,770540,770540,0,1,86,0,0,0,0,0,ICMPV6,Network,0,6,,,,,
111,111,0,192.168.1.168,f4:f5:d8:45:9f:1a,f4:f5:d8,5353,224.0.0.251,01:00:5e:00:00:fb,01:00:5e,5353,17,4,0,0,686537,747977,61440,2,768,686537,747977,61440,2,768,0,0,0,0,0,MDNS,Network,0,6,_googlecast._tcp.local,,,,
113,113,0,0.0.0.0,d8:58:d7:00:0f:72,d8:58:d7,0,224.0.0.1,01:00:5e:00:00:01,01:00:5e,0,2,4,0,0,805188,805188,0,1,60,805188,805188,0,1,60,0,0,0,0,0,IGMP,Network,0,6,,,,,
119,119,0,fe80::f106:5909:32ae:f4cb,08:00:27:11:4e:fa,08:00:27,0,ff02::1:ffae:f4cb,33:33:ff:ae:f4:cb,33:33:ff,0,58,6,0,0,892998,892998,0,1,86,892998,892998,0,1,86,0,0,0,0,0,ICMPV6,Network,0,6,,,,,
120,120,0,fe80::e8ff:97da:2f7f:abb3,08:00:27:38:31:62,08:00:27,0,ff02::1:ff00:b30,33:33:ff:00:0b:30,33:33:ff,0,58,6,0,0,896714,896714,0,1,86,896714,896714,0,1,86,0,0,0,0,0,ICMPV6,Network,0,6,,,,,
121,121,0,fe80::e8ff:97da:2f7f:abb3,08:00:27:38:31:62,08:00:27,0,ff02::1:ff00:f72,33:33:ff:00:0f:72,33:33:ff,0,58,6,0,0,625909,850324,224415,4,344,625909,850324,224415,4,344,0,0,0,0,0,ICMPV6,Network,0,6,,,,,
123,123,0,fe80::e8ff:97da:2f7f:abb3,08:00:27:38:31:62,08:00:27,0,ff02::1:ff62:aec8,33:33:ff:62:ae:c8,33:33:ff,0,58,6,0,0,892207,892207,0,1,86,892207,892207,0,1,86,0,0,0,0,0,ICMPV6,Network,0,6,,,,,
124,124,0,fe80::e8ff:97da:2f7f:abb3,08:00:27:38:31:62,08:00:27,0,ff02::1:ff7f:abb3,33:33:ff:7f:ab:b3,33:33:ff,0,58,6,0,0,894210,894210,0,1,86,894210,894210,0,1,86,0,0,0,0,0,ICMPV6,Network,0,6,,,,,
125,125,0,fe80::5dd3:6bb3:7720:1e83,08:00:27:52:f4:11,08:00:27,0,ff02::1:ff2b:5398,33:33:ff:2b:53:98,33:33:ff,0,58,6,0,0,896541,896541,0,1,86,896541,896541,0,1,86,0,0,0,0,0,ICMPV6,Network,0,6,,,,,
126,126,0,fe80::5dd3:6bb3:7720:1e83,08:00:27:52:f4:11,08:00:27,0,ff02::1:ff00:2c6,33:33:ff:00:02:c6,33:33:ff,0,58,6,0,0,894038,894038,0,1,86,894038,894038,0,1,86,0,0,0,0,0,ICMPV6,Network,0,6,,,,,
127,127,0,fe80::5dd3:6bb3:7720:1e83,08:00:27:52:f4:11,08:00:27,0,ff02::1:ff20:1e83,33:33:ff:20:1e:83,33:33:ff,0,58,6,0,0,898544,898544,0,1,86,898544,898544,0,1,86,0,0,0,0,0,ICMPV6,Network,0,6,,,,,
128,128,0,fe80::f106:5909:32ae:f4cb,08:00:27:11:4e:fa,08:00:27,0,ff02::1:ffcc:1f02,33:33:ff:cc:1f:02,33:33:ff,0,58,6,0,0,894500,894500,0,1,86,894500,894500,0,1,86,0,0,0,0,0,ICMPV6,Network,0,6,,,,,
129,129,0,fe80::f106:5909:32ae:f4cb,08:00:27:11:4e:fa,08:00:27,0,ff02::1:ff00:4f7,33:33:ff:00:04:f7,33:33:ff,0,58,6,0,0,893999,893999,0,1,86,893999,893999,0,1,86,0,0,0,0,0,ICMPV6,Network,0,6,,,,,
132,132,0,0.0.0.0,d8:58:d7:00:0f:72,d8:58:d7,0,224.0.0.1,01:00:5e:00:00:01,01:00:5e,0,2,4,0,0,930627,930627,0,1,60,930627,930627,0,1,60,0,0,0,0,0,IGMP,Network,0,6,,,,,
140,140,0,fe80::da58:d7ff:fe00:f72,d8:58:d7:00:0f:72,d8:58:d7,0,ff02::1,33:33:00:00:00:01,33:33:00,0,58,6,0,0,890692,1016131,125439,3,370,890692,1016131,125439,3,370,0,0,0,0,0,ICMPV6,Network,0,6,,,,,
141,141,0,fe80::e8ff:97da:2f7f:abb3,08:00:27:38:31:62,08:00:27,0,ff02::1:ff7f:abb3,33:33:ff:7f:ab:b3,33:33:ff,0,58,6,0,0,1021714,1021714,0,1,86,1021714,1021714,0,1,86,0,0,0,0,0,ICMPV6,Network,0,6,,,,,
142,142,0,fe80::5dd3:6bb3:7720:1e83,08:00:27:52:f4:11,08:00:27,0,ff02::1:ff00:2c6,33:33:ff:00:02:c6,33:33:ff,0,58,6,0,0,1022042,1022042,0,1,86,1022042,1022042,0,1,86,0,0,0,0,0,ICMPV6,Network,0,6,,,,,
143,143,0,fe80::e8ff:97da:2f7f:abb3,08:00:27:38:31:62,08:00:27,0,ff02::1:ff00:b30,33:33:ff:00:0b:30,33:33:ff,0,58,6,0,0,1017207,1017207,0,1,86,1017207,1017207,0,1,86,0,0,0,0,0,ICMPV6,Network,0,6,,,,,
144,144,0,fe80::e8ff:97da:2f7f:abb3,08:00:27:38:31:62,08:00:27,0,ff02::1:ff62:aec8,33:33:ff:62:ae:c8,33:33:ff,0,58,6,0,0,1020211,1020211,0,1,86,1020211,1020211,0,1,86,0,0,0,0,0,ICMPV6,Network,0,6,,,,,
145,145,0,fe80::f106:5909:32ae:f4cb,08:00:27:11:4e:fa,08:00:27,0,ff02::1:ffcc:1f02,33:33:ff:cc:1f:02,33:33:ff,0,58,6,0,0,1023996,1023996,0,1,86,1023996,1023996,0,1,86,0,0,0,0,0,ICMPV6,Network,0,6,,,,,
146,146,0,fe80::5dd3:6bb3:7720:1e83,08:00:27:52:f4:11,08:00:27,0,ff02::1:ff20:1e83,33:33:ff:20:1e:83,33:33:ff,0,58,6,0,0,1023044,1023044,0,1,86,1023044,1023044,0,1,86,0,0,0,0,0,ICMPV6,Network,0,6,,,,,
147,147,0,fe80::5dd3:6bb3:7720:1e83,08:00:27:52:f4:11,08:00:27,0,ff02::1:ff2b:5398,33:33:ff:2b:53:98,33:33:ff,0,58,6,0,0,1022042,1022042,0,1,86,1022042,1022042,0,1,86,0,0,0,0,0,ICMPV6,Network,0,6,,,,,
148,148,0,fe80::f106:5909:32ae:f4cb,08:00:27:11:4e:fa,08:00:27,0,ff02::1:ffae:f4cb,33:33:ff:ae:f4:cb,33:33:ff,0,58,6,0,0,1016495,1016495,0,1,86,1016495,1016495,0,1,86,0,0,0,0,0,ICMPV6,Network,0,6,,,,,
150,150,0,192.168.1.168,f4:f5:d8:45:9f:1a,f4:f5:d8,5353,224.0.0.251,01:00:5e:00:00:fb,01:00:5e,5353,17,4,0,0,926570,987816,61246,2,768,926570,987816,61246,2,768,0,0,0,0,0,MDNS,Network,0,6,_googlecast._tcp.local,,,,
154,154,0,0.0.0.0,d8:58:d7:00:0f:72,d8:58:d7,0,224.0.0.1,01:00:5e:00:00:01,01:00:5e,0,2,4,0,0,1056066,1056066,0,1,60,1056066,1056066,0,1,60,0,0,0,0,0,IGMP,Network,0,6,,,,,
163,163,0,fe80::da58:d7ff:fe00:f72,d8:58:d7:00:0f:72,d8:58:d7,0,ff02::1,33:33:00:00:00:01,33:33:00,0,58,6,0,0,1141570,1141570,0,1,86,1141570,1141570,0,1,86,0,0,0,0,0,ICMPV6,Network,0,6,,,,,
164,164,0,fe80::5dd3:6bb3:7720:1e83,08:00:27:52:f4:11,08:00:27,0,ff02::1:ff00:2c6,33:33:ff:00:02:c6,33:33:ff,0,58,6,0,0,1142535,1142535,0,1,86,1142535,1142535,0,1,86,0,0,0,0,0,ICMPV6,Network,0,6,,,,,
166,166,0,fe80::e8ff:97da:2f7f:abb3,08:00:27:38:31:62,08:00:27,0,ff02::1:ff00:b30,33:33:ff:00:0b:30,33:33:ff,0,58,6,0,0,1144710,1144710,0,1,86,1144710,1144710,0,1,86,0,0,0,0,0,ICMPV6,Network,0,6,,,,,
167,167,0,fe80::e8ff:97da:2f7f:abb3,08:00:27:38:31:62,08:00:27,0,ff02::1:ff62:aec8,33:33:ff:62:ae:c8,33:33:ff,0,58,6,0,0,1147214,1147214,0,1,86,1147214,1147214,0,1,86,0,0,0,0,0,ICMPV6,Network,0,6,,,,,
168,168,0,fe80::f106:5909:32ae:f4cb,08:00:27:11:4e:fa,08:00:27,0,ff02::1:ffcc:1f02,33:33:ff:cc:1f:02,33:33:ff,0,58,6,0,0,1147994,1147994,0,1,86,1147994,1147994,0,1,86,0,0,0,0,0,ICMPV6,Network,0,6,,,,,
169,169,0,fe80::5dd3:6bb3:7720:1e83,08:00:27:52:f4:11,08:00:27,0,ff02::1:ff2b:5398,33:33:ff:2b:53:98,33:33:ff,0,58,6,0,0,1149535,1149535,0,1,86,1149535,1149535,0,1,86,0,0,0,0,0,ICMPV6,Network,0,6,,,,,
170,170,0,fe80::f106:5909:32ae:f4cb,08:00:27:11:4e:fa,08:00:27,0,ff02::1:ff00:4f7,33:33:ff:00:04:f7,33:33:ff,0,58,6,0,0,1024997,1142497,117500,2,172,1024997,1142497,117500,2,172,0,0,0,0,0,ICMPV6,Network,0,6,,,,,
171,171,0,fe80::f106:5909:32ae:f4cb,08:00:27:11:4e:fa,08:00:27,0,ff02::1:ffae:f4cb,33:33:ff:ae:f4:cb,33:33:ff,0,58,6,0,0,1150999,1150999,0,1,86,1150999,1150999,0,1,86,0,0,0,0,0,ICMPV6,Network,0,6,,,,,
172,172,0,fe80::e8ff:97da:2f7f:abb3,08:00:27:38:31:62,08:00:27,0,ff02::1:ff7f:abb3,33:33:ff:7f:ab:b3,33:33:ff,0,58,6,0,0,1141716,1141716,0,1,86,1141716,1141716,0,1,86,0,0,0,0,0,ICMPV6,Network,0,6,,,,,
173,173,0,fe80::5dd3:6bb3:7720:1e83,08:00:27:52:f4:11,08:00:27,0,ff02::1:ff20:1e83,33:33:ff:20:1e:83,33:33:ff,0,58,6,0,0,1148043,1148043,0,1,86,1148043,1148043,0,1,86,0,0,0,0,0,ICMPV6,Network,0,6,,,,,
175,175,0,0.0.0.0,d8:58:d7:00:0f:72,d8:58:d7,0,224.0.0.1,01:00:5e:00:00:01,01:00:5e,0,2,4,0,0,1181506,1181506,0,1,60,1181506,1181506,0,1,60,0,0,0,0,0,IGMP,Network,0,6,,,,,
189,189,0,fe80::da58:d7ff:fe00:f72,d8:58:d7:00:0f:72,d8:58:d7,0,ff02::1,33:33:00:00:00:01,33:33:00,0,58,6,0,0,1267009,1267009,0,1,86,1267009,1267009,0,1,86,0,0,0,0,0,ICMPV6,Network,0,6,,,,,
190,190,0,fe80::e8ff:97da:2f7f:abb3,08:00:27:38:31:62,08:00:27,0,ff02::1:ff00:b30,33:33:ff:00:0b:30,33:33:ff,0,58,6,0,0,1270711,1270711,0,1,86,1270711,1270711,0,1,86,0,0,0,0,0,ICMPV6,Network,0,6,,,,,
191,191,0,fe80::f106:5909:32ae:f4cb,08:00:27:11:4e:fa,08:00:27,0,ff02::1:ff00:4f7,33:33:ff:00:04:f7,33:33:ff,0,58,6,0,0,1272493,1272493,0,1,86,1272493,1272493,0,1,86,0,0,0,0,0,ICMPV6,Network,0,6,,,,,
192,192,0,fe80::e8ff:97da:2f7f:abb3,08:00:27:38:31:62,08:00:27,0,ff02::1:ff7f:abb3,33:33:ff:7f:ab:b3,33:33:ff,0,58,6,0,0,1274707,1274707,0,1,86,1274707,1274707,0,1,86,0,0,0,0,0,ICMPV6,Network,0,6,,,,,
193,193,0,fe80::f106:5909:32ae:f4cb,08:00:27:11:4e:fa,08:00:27,0,ff02::1:ffcc:1f02,33:33:ff:cc:1f:02,33:33:ff,0,58,6,0,0,1271992,1271992,0,1,86,1271992,1271992,0,1,86,0,0,0,0,0,ICMPV6,Network,0,6,,,,,
194,194,0,fe80::5dd3:6bb3:7720:1e83,08:00:27:52:f4:11,08:00:27,0,ff02::1:ff20:1e83,33:33:ff:20:1e:83,33:33:ff,0,58,6,0,0,1276038,1276038,0,1,86,1276038,1276038,0,1,86,0,0,0,0,0,ICMPV6,Network,0,6,,,,,
195,195,0,fe80::5dd3:6bb3:7720:1e83,08:00:27:52:f4:11,08:00:27,0,ff02::1:ff00:2c6,33:33:ff:00:02:c6,33:33:ff,0,58,6,0,0,1269037,1269037,0,1,86,1269037,1269037,0,1,86,0,0,0,0,0,ICMPV6,Network,0,6,,,,,
196,196,0,fe80::e8ff:97da:2f7f:abb3,08:00:27:38:31:62,08:00:27,0,ff02::1:ff62:aec8,33:33:ff:62:ae:c8,33:33:ff,0,58,6,0,0,1271213,1271213,0,1,86,1271213,1271213,0,1,86,0,0,0,0,0,ICMPV6,Network,0,6,,,,,
197,197,0,fe80::5dd3:6bb3:7720:1e83,08:00:27:52:f4:11,08:00:27,0,ff02::1:ff2b:5398,33:33:ff:2b:53:98,33:33:ff,0,58,6,0,0,1272042,1272042,0,1,86,1272042,1272042,0,1,86,0,0,0,0,0,ICMPV6,Network,0,6,,,,,
202,202,0,0.0.0.0,d8:58:d7:00:0f:72,d8:58:d7,0,224.0.0.1,01:00:5e:00:00:01,01:00:5e,0,2,4,0,0,1306945,1306945,0,1,60,1306945,1306945,0,1,60,0,0,0,0,0,IGMP,Network,0,6,,,,,
217,217,0,fe80::f106:5909:32ae:f4cb,08:00:27:11:4e:fa,08:00:27,0,ff02::1:ff00:4f7,33:33:ff:00:04:f7,33:33:ff,0,58,6,0,0,1394499,1394499,0,1,86,1394499,1394499,0,1,86,0,0,0,0,0,ICMPV6,Network,0,6,,,,,
219,219,0,fe80::f106:5909:32ae:f4cb,08:00:27:11:4e:fa,08:00:27,0,ff02::1:ffae:f4cb,33:33:ff:ae:f4:cb,33:33:ff,0,58,6,0,0,1273996,1392997,119001,2,172,1273996,1392997,119001,2,172,0,0,0,0,0,ICMPV6,Network,0,6,,,,,
220,220,0,fe80::e8ff:97da:2f7f:abb3,08:00:27:38:31:62,08:00:27,0,ff02::1:ff00:b30,33:33:ff:00:0b:30,33:33:ff,0,58,6,0,0,1393709,1393709,0,1,86,1393709,1393709,0,1,86,0,0,0,0,0,ICMPV6,Network,0,6,,,,,
221,221,0,fe80::5dd3:6bb3:7720:1e83,08:00:27:52:f4:11,08:00:27,0,ff02::1:ff20:1e83,33:33:ff:20:1e:83,33:33:ff,0,58,6,0,0,1398043,1398043,0,1,86,1398043,1398043,0,1,86,0,0,0,0,0,ICMPV6,Network,0,6,,,,,
222,222,0,fe80::e8ff:97da:2f7f:abb3,08:00:27:38:31:62,08:00:27,0,ff02::1:ff7f:abb3,33:33:ff:7f:ab:b3,33:33:ff,0,58,6,0,0,1397214,1397214,0,1,86,1397214,1397214,0,1,86,0,0,0,0,0,ICMPV6,Network,0,6,,,,,
223,223,0,fe80::e8ff:97da:2f7f:abb3,08:00:27:38:31:62,08:00:27,0,ff02::1:ff62:aec8,33:33:ff:62:ae:c8,33:33:ff,0,58,6,0,0,1400708,1400708,0,1,86,1400708,1400708,0,1,86,0,0,0,0,0,ICMPV6,Network,0,6,,,,,
224,224,0,fe80::5dd3:6bb3:7720:1e83,08:00:27:52:f4:11,08:00:27,0,ff02::1:ff2b:5398,33:33:ff:2b:53:98,33:33:ff,0,58,6,0,0,1401037,1401037,0,1,86,1401037,1401037,0,1,86,0,0,0,0,0,ICMPV6,Network,0,6,,,,,
225,225,0,fe80::f106:5909:32ae:f4cb,08:00:27:11:4e:fa,08:00:27,0,ff02::1:ffcc:1f02,33:33:ff:cc:1f:02,33:33:ff,0,58,6,0,0,1397994,1397994,0,1,86,1397994,1397994,0,1,86,0,0,0,0,0,ICMPV6,Network,0,6,,,,,
237,237,0,0.0.0.0,d8:58:d7:00:0f:72,d8:58:d7,0,224.0.0.1,01:00:5e:00:00:01,01:00:5e,0,2,4,0,0,1432385,1432385,0,1,60,1432385,1432385,0,1,60,0,0,0,0,0,IGMP,Network,0,6,,,,,
243,243,0,192.168.1.166,a4:5e:60:dd:58:1d,a4:5e:60,138,192.168.1.255,ff:ff:ff:ff:ff:ff,ff:ff:ff,138,17,4,0,0,881029,981454,100425,4,864,881029,981454,100425,4,864,0,0,0,0,0,NetBIOS.SMBv1,System,0,6,macbookpro-581d,,,,
252,252,0,fe80::da58:d7ff:fe00:f72,d8:58:d7:00:0f:72,d8:58:d7,0,ff02::1,33:33:00:00:00:01,33:33:00,0,58,6,0,0,1392449,1517889,125440,3,370,1392449,1517889,125440,3,370,0,0,0,0,0,ICMPV6,Network,0,6,,,,,
253,253,0,fe80::f106:5909:32ae:f4cb,08:00:27:11:4e:fa,08:00:27,0,ff02::1:ffae:f4cb,33:33:ff:ae:f4:cb,33:33:ff,0,58,6,0,0,1518497,1518497,0,1,86,1518497,1518497,0,1,86,0,0,0,0,0,ICMPV6,Network,0,6,,,,,
254,254,0,fe80::e8ff:97da:2f7f:abb3,08:00:27:38:31:62,08:00:27,0,ff02::1:ff62:aec8,33:33:ff:62:ae:c8,33:33:ff,0,58,6,0,0,1523215,1523215,0,1,86,1523215,1523215,0,1,86,0,0,0,0,0,ICMPV6,Network,0,6,,,,,
255,255,0,fe80::5dd3:6bb3:7720:1e83,08:00:27:52:f4:11,08:00:27,0,ff02::1:ff2b:5398,33:33:ff:2b:53:98,33:33:ff,0,58,6,0,0,1523543,1523543,0,1,86,1523543,1523543,0,1,86,0,0,0,0,0,ICMPV6,Network,0,6,,,,,
256,256,0,fe80::5dd3:6bb3:7720:1e83,08:00:27:52:f4:11,08:00:27,0,ff02::1:ff20:1e83,33:33:ff:20:1e:83,33:33:ff,0,58,6,0,0,1522041,1522041,0,1,86,1522041,1522041,0,1,86,0,0,0,0,0,ICMPV6,Network,0,6,,,,,
257,257,0,fe80::f106:5909:32ae:f4cb,08:00:27:11:4e:fa,08:00:27,0,ff02::1:ff00:4f7,33:33:ff:00:04:f7,33:33:ff,0,58,6,0,0,1517996,1517996,0,1,86,1517996,1517996,0,1,86,0,0,0,0,0,ICMPV6,Network,0,6,,,,,
259,259,0,fe80::f106:5909:32ae:f4cb,08:00:27:11:4e:fa,08:00:27,0,ff02::1:ffcc:1f02,33:33:ff:cc:1f:02,33:33:ff,0,58,6,0,0,1526498,1526498,0,1,86,1526498,1526498,0,1,86,0,0,0,0,0,ICMPV6,Network,0,6,,,,,
260,260,0,fe80::5dd3:6bb3:7720:1e83,08:00:27:52:f4:11,08:00:27,0,ff02::1:ff00:2c6,33:33:ff:00:02:c6,33:33:ff,0,58,6,0,0,1398544,1518536,119992,2,172,1398544,1518536,119992,2,172,0,0,0,0,0,ICMPV6,Network,0,6,,,,,
261,261,0,fe80::e8ff:97da:2f7f:abb3,08:00:27:38:31:62,08:00:27,0,ff02::1:ff7f:abb3,33:33:ff:7f:ab:b3,33:33:ff,0,58,6,0,0,1523214,1523214,0,1,86,1523214,1523214,0,1,86,0,0,0,0,0,ICMPV6,Network,0,6,,,,,
262,262,0,fe80::e8ff:97da:2f7f:abb3,08:00:27:38:31:62,08:00:27,0,ff02::1:ff00:b30,33:33:ff:00:0b:30,33:33:ff,0,58,6,0,0,1521211,1521211,0,1,86,1521211,1521211,0,1,86,0,0,0,0,0,ICMPV6,Network,0,6,,,,,
267,267,0,fe80::5dd3:6bb3:7720:1e83,08:00:27:52:f4:11,08:00:27,0,ff02::1:ff00:f72,33:33:ff:00:0f:72,33:33:ff,0,58,6,0,0,830564,1029043,198479,4,344,830564,1029043,198479,4,344,0,0,0,0,0,ICMPV6,Network,0,6,,,,,
268,268,0,0.0.0.0,d8:58:d7:00:0f:72,d8:58:d7,0,224.0.0.1,01:00:5e:00:00:01,01:00:5e,0,2,4,0,0,1557825,1557825,0,1,60,1557825,1557825,0,1,60,0,0,0,0,0,IGMP,Network,0,6,,,,,
291,291,0,fe80::da58:d7ff:fe00:f72,d8:58:d7:00:0f:72,d8:58:d7,0,ff02::1,33:33:00:00:00:01,33:33:00,0,58,6,0,0,1643328,1643328,0,1,86,1643328,1643328,0,1,86,0,0,0,0,0,ICMPV6,Network,0,6,,,,,
292,292,0,fe80::e8ff:97da:2f7f:abb3,08:00:27:38:31:62,08:00:27,0,ff02::1:ff62:aec8,33:33:ff:62:ae:c8,33:33:ff,0,58,6,0,0,1644208,1644208,0,1,86,1644208,1644208,0,1,86,0,0,0,0,0,ICMPV6,Network,0,6,,,,,
293,293,0,fe80::f106:5909:32ae:f4cb,08:00:27:11:4e:fa,08:00:27,0,ff02::1:ffcc:1f02,33:33:ff:cc:1f:02,33:33:ff,0,58,6,0,0,1649506,1649506,0,1,86,1649506,1649506,0,1,86,0,0,0,0,0,ICMPV6,Network,0,6,,,,,
294,294,0,fe80::5dd3:6bb3:7720:1e83,08:00:27:52:f4:11,08:00:27,0,ff02::1:ff2b:5398,33:33:ff:2b:53:98,33:33:ff,0,58,6,0,0,1645538,1645538,0,1,86,1645538,1645538,0,1,86,0,0,0,0,0,ICMPV6,Network,0,6,,,,,
295,295,0,fe80::e8ff:97da:2f7f:abb3,08:00:27:38:31:62,08:00:27,0,ff02::1:ff7f:abb3,33:33:ff:7f:ab:b3,33:33:ff,0,58,6,0,0,1652711,1652711,0,1,86,1652711,1652711,0,1,86,0,0,0,0,0,ICMPV6,Network,0,6,,,,,
296,296,0,fe80::f106:5909:32ae:f4cb,08:00:27:11:4e:fa,08:00:27,0,ff02::1:ffae:f4cb,33:33:ff:ae:f4:cb,33:33:ff,0,58,6,0,0,1644007,1644007,0,1,86,1644007,1644007,0,1,86,0,0,0,0,0,ICMPV6,Network,0,6,,,,,
297,297,0,fe80::f106:5909:32ae:f4cb,08:00:27:11:4e:fa,08:00:27,0,ff02::1:ff00:4f7,33:33:ff:00:04:f7,33:33:ff,0,58,6,0,0,1647502,1647502,0,1,86,1647502,1647502,0,1,86,0,0,0,0,0,ICMPV6,Network,0,6,,,,,
298,298,0,fe80::5dd3:6bb3:7720:1e83,08:00:27:52:f4:11,08:00:27,0,ff02::1:ff00:2c6,33:33:ff:00:02:c6,33:33:ff,0,58,6,0,0,1650536,1650536,0,1,86,1650536,1650536,0,1,86,0,0,0,0,0,ICMPV6,Network,0,6,,,,,
299,299,0,fe80::e8ff:97da:2f7f:abb3,08:00:27:38:31:62,08:00:27,0,ff02::1:ff00:b30,33:33:ff:00:0b:30,33:33:ff,0,58,6,0,0,1652711,1652711,0,1,86,1652711,1652711,0,1,86,0,0,0,0,0,ICMPV6,Network,0,6,,,,,
300,300,0,fe80::5dd3:6bb3:7720:1e83,08:00:27:52:f4:11,08:00:27,0,ff02::1:ff20:1e83,33:33:ff:20:1e:83,33:33:ff,0,58,6,0,0,1647041,1647041,0,1,86,1647041,1647041,0,1,86,0,0,0,0,0,ICMPV6,Network,0,6,,,,,
304,304,0,fe80::e8ff:97da:2f7f:abb3,08:00:27:38:31:62,08:00:27,0,ff02::1:ff00:f72,33:33:ff:00:0f:72,33:33:ff,0,58,6,0,0,1018787,1018787,0,1,86,1018787,1018787,0,1,86,0,0,0,0,0,ICMPV6,Network,0,6,,,,,
306,306,0,0.0.0.0,d8:58:d7:00:0f:72,d8:58:d7,0,224.0.0.1,01:00:5e:00:00:01,01:00:5e,0,2,4,0,0,1683264,1683264,0,1,60,1683264,1683264,0,1,60,0,0,0,0,0,IGMP,Network,0,6,,,,,
310,310,0,fd2d:ab8c:225:0:81d3:fd3e:7f62:aec8,08:00:27:38:31:62,08:00:27,0,ff02::1:ff00:1,33:33:ff:00:00:01,33:33:ff,0,58,6,0,0,196131,196131,0,1,86,196131,196131,0,1,86,0,0,0,0,0,ICMPV6,Network,0,6,,,,,
321,321,0,fe80::da58:d7ff:fe00:f72,d8:58:d7:00:0f:72,d8:58:d7,0,ff02::1,33:33:00:00:00:01,33:33:00,0,58,6,0,0,1768768,1768768,0,1,86,1768768,1768768,0,1,86,0,0,0,0,0,ICMPV6,Network,0,6,,,,,
322,322,0,fe80::e8ff:97da:2f7f:abb3,08:00:27:38:31:62,08:00:27,0,ff02::1:ff00:b30,33:33:ff:00:0b:30,33:33:ff,0,58,6,0,0,1773715,1773715,0,1,86,1773715,1773715,0,1,86,0,0,0,0,0,ICMPV6,Network,0,6,,,,,
323,323,0,fe80::e8ff:97da:2f7f:abb3,08:00:27:38:31:62,08:00:27,0,ff02::1:ff62:aec8,33:33:ff:62:ae:c8,33:33:ff,0,58,6,0,0,1769208,1769208,0,1,86,1769208,1769208,0,1,86,0,0,0,0,0,ICMPV6,Network,0,6,,,,,
324,324,0,fe80::f106:5909:32ae:f4cb,08:00:27:11:4e:fa,08:00:27,0,ff02::1:ff00:4f7,33:33:ff:00:04:f7,33:33:ff,0,58,6,0,0,1773003,1773003,0,1,86,1773003,1773003,0,1,86,0,0,0,0,0,ICMPV6,Network,0,6,,,,,
325,325,0,fe80::e8ff:97da:2f7f:abb3,08:00:27:38:31:62,08:00:27,0,ff02::1:ff7f:abb3,33:33:ff:7f:ab:b3,33:33:ff,0,58,6,0,0,1772714,1772714,0,1,86,1772714,1772714,0,1,86,0,0,0,0,0,ICMPV6,Network,0,6,,,,,
327,327,0,fe80::5dd3:6bb3:7720:1e83,08:00:27:52:f4:11,08:00:27,0,ff02::1:ff00:2c6,33:33:ff:00:02:c6,33:33:ff,0,58,6,0,0,1773042,1773042,0,1,86,1773042,1773042,0,1,86,0,0,0,0,0,ICMPV6,Network,0,6,,,,,
328,328,0,fe80::f106:5909:32ae:f4cb,08:00:27:11:4e:fa,08:00:27,0,ff02::1:ffcc:1f02,33:33:ff:cc:1f:02,33:33:ff,0,58,6,0,0,1770510,1770510,0,1,86,1770510,1770510,0,1,86,0,0,0,0,0,ICMPV6,Network,0,6,,,,,
329,329,0,fe80::f106:5909:32ae:f4cb,08:00:27:11:4e:fa,08:00:27,0,ff02::1:ffae:f4cb,33:33:ff:ae:f4:cb,33:33:ff,0,58,6,0,0,1773003,1773003,0,1,86,1773003,1773003,0,1,86,0,0,0,0,0,ICMPV6,Network,0,6,,,,,
330,330,0,fe80::5dd3:6bb3:7720:1e83,08:00:27:52:f4:11,08:00:27,0,ff02::1:ff2b:5398,33:33:ff:2b:53:98,33:33:ff,0,58,6,0,0,1772541,1772541,0,1,86,1772541,1772541,0,1,86,0,0,0,0,0,ICMPV6,Network,0,6,,,,,
335,335,0,0.0.0.0,d8:58:d7:00:0f:72,d8:58:d7,0,224.0.0.1,01:00:5e:00:00:01,01:00:5e,0,2,4,0,0,1808704,1808704,0,1,60,1808704,1808704,0,1,60,0,0,0,0,0,IGMP,Network,0,6,,,,,
348,348,0,192.168.1.168,f4:f5:d8:45:9f:1a,f4:f5:d8,5353,224.0.0.251,01:00:5e:00:00:fb,01:00:5e,5353,17,4,0,0,1767693,1827910,60217,2,768,1767693,1827910,60217,2,768,0,0,0,0,0,MDNS,Network,0,6,_googlecast._tcp.local,,,,
357,357,0,fe80::da58:d7ff:fe00:f72,d8:58:d7:00:0f:72,d8:58:d7,0,ff02::1,33:33:00:00:00:01,33:33:00,0,58,6,0,0,1894208,1894208,0,1,86,1894208,1894208,0,1,86,0,0,0,0,0,ICMPV6,Network,0,6,,,,,
358,358,0,fe80::5dd3:6bb3:7720:1e83,08:00:27:52:f4:11,08:00:27,0,ff02::1:ff00:2c6,33:33:ff:00:02:c6,33:33:ff,0,58,6,0,0,1899544,1899544,0,1,86,1899544,1899544,0,1,86,0,0,0,0,0,ICMPV6,Network,0,6,,,,,
359,359,0,fe80::f106:5909:32ae:f4cb,08:00:27:11:4e:fa,08:00:27,0,ff02::1:ff00:4f7,33:33:ff:00:04:f7,33:33:ff,0,58,6,0,0,1896511,1896511,0,1,86,1896511,1896511,0,1,86,0,0,0,0,0,ICMPV6,Network,0,6,,,,,
360,360,0,fe80::e8ff:97da:2f7f:abb3,08:00:27:38:31:62,08:00:27,0,ff02::1:ff7f:abb3,33:33:ff:7f:ab:b3,33:33:ff,0,58,6,0,0,1897713,1897713,0,1,86,1897713,1897713,0,1,86,0,0,0,0,0,ICMPV6,Network,0,6,,,,,
361,361,0,fe80::f106:5909:32ae:f4cb,08:00:27:11:4e:fa,08:00:27,0,ff02::1:ffcc:1f02,33:33:ff:cc:1f:02,33:33:ff,0,58,6,0,0,1900506,1900506,0,1,86,1900506,1900506,0,1,86,0,0,0,0,0,ICMPV6,Network,0,6,,,,,
362,362,0,fe80::e8ff:97da:2f7f:abb3,08:00:27:38:31:62,08:00:27,0,ff02::1:ff62:aec8,33:33:ff:62:ae:c8,33:33:ff,0,58,6,0,0,1896211,1896211,0,1,86,1896211,1896211,0,1,86,0,0,0,0,0,ICMPV6,Network,0,6,,,,,
364,364,0,fe80::e8ff:97da:2f7f:abb3,08:00:27:38:31:62,08:00:27,0,ff02::1:ff00:b30,33:33:ff:00:0b:30,33:33:ff,0,58,6,0,0,1894709,1894709,0,1,86,1894709,1894709,0,1,86,0,0,0,0,0,ICMPV6,Network,0,6,,,,,
365,365,0,fe80::5dd3:6bb3:7720:1e83,08:00:27:52:f4:11,08:00:27,0,ff02::1:ff20:1e83,33:33:ff:20:1e:83,33:33:ff,0,58,6,0,0,1774544,1894536,119992,2,172,1774544,1894536,119992,2,172,0,0,0,0,0,ICMPV6,Network,0,6,,,,,
497,497,0,fd2d:ab8c:225:0:81d3:fd3e:7f62:aec8,08:00:27:38:31:62,08:00:27,62098,fd2d:ab8c:225::1,d8:58:d7:00:0f:72,d8:58:d7,53,17,6,0,0,279089,279089,0,2,176,279089,279089,0,1,88,279089,279089,0,1,88,DNS,Network,0,6,wpad.lan,,,,
498,498,0,fe80::e8ff:97da:2f7f:abb3,08:00:27:38:31:62,08:00:27,53639,ff02::1:3,33:33:00:01:00:03,33:33:00,5355,17,6,0,0,279090,279187,97,2,168,279090,279187,97,2,168,0,0,0,0,0,LLMNR,Network,0,6,wpad,,,,
499,499,0,192.168.1.115,08:00:27:38:31:62,08:00:27,59641,224.0.0.252,01:00:5e:00:00:fc,01:00:5e,5355,17,4,0,0,279090,279187,97,2,128,279090,279187,97,2,128,0,0,0,0,0,LLMNR,Network,0,6,wpad,,,,
500,500,0,192.168.1.115,08:00:27:38:31:62,08:00:27,137,192.168.1.255,ff:ff:ff:ff:ff:ff,ff:ff:ff,137,17,4,0,0,279387,280888,1501,3,276,279387,280888,1501,3,276,0,0,0,0,0,NetBIOS,System,0,6,wpad,,,,
514,514,0,0.0.0.0,d8:58:d7:00:0f:72,d8:58:d7,0,224.0.0.1,01:00:5e:00:00:01,01:00:5e,0,2,4,0,0,1934143,1934143,0,1,60,1934143,1934143,0,1,60,0,0,0,0,0,IGMP,Network,0,6,,,,,
2688,2688,0,192.168.1.166,a4:5e:60:dd:58:1d,a4:5e:60,138,192.168.1.255,ff:ff:ff:ff:ff:ff,ff:ff:ff,138,17,4,0,0,1581483,1581538,55,2,432,1581483,1581538,55,2,432,0,0,0,0,0,NetBIOS.SMBv1,System,0,6,macbookpro-581d,,,,
2868,2868,0,fe80::5dd3:6bb3:7720:1e83,08:00:27:52:f4:11,08:00:27,0,ff02::1:ff00:f72,33:33:ff:00:0f:72,33:33:ff,0,58,6,0,0,1680385,1906688,226303,4,344,1680385,1906688,226303,4,344,0,0,0,0,0,ICMPV6,Network,0,6,,,,,
3085,3085,0,fe80::e8ff:97da:2f7f:abb3,08:00:27:38:31:62,08:00:27,0,ff02::1:ff00:f72,33:33:ff:00:0f:72,33:33:ff,0,58,6,0,0,1804352,1903728,99376,2,172,1804352,1903728,99376,2,172,0,0,0,0,0,ICMPV6,Network,0,6,,,,,
3137,3137,0,fe80::e8ff:97da:2f7f:abb3,08:00:27:38:31:62,08:00:27,0,ff02::1:ff62:aec8,33:33:ff:62:ae:c8,33:33:ff,0,58,6,0,0,2024215,2024215,0,1,86,2024215,2024215,0,1,86,0,0,0,0,0,ICMPV6,Network,0,6,,,,,
3138,3138,0,fe80::f106:5909:32ae:f4cb,08:00:27:11:4e:fa,08:00:27,0,ff02::1:ffcc:1f02,33:33:ff:cc:1f:02,33:33:ff,0,58,6,0,0,2024004,2024004,0,1,86,2024004,2024004,0,1,86,0,0,0,0,0,ICMPV6,Network,0,6,,,,,
3139,3139,0,fe80::5dd3:6bb3:7720:1e83,08:00:27:52:f4:11,08:00:27,0,ff02::1:ff00:2c6,33:33:ff:00:02:c6,33:33:ff,0,58,6,0,0,2020037,2020037,0,1,86,2020037,2020037,0,1,86,0,0,0,0,0,ICMPV6,Network,0,6,,,,,
3140,3140,0,fe80::e8ff:97da:2f7f:abb3,08:00:27:38:31:62,08:00:27,0,ff02::1:ff7f:abb3,33:33:ff:7f:ab:b3,33:33:ff,0,58,6,0,0,2022713,2022713,0,1,86,2022713,2022713,0,1,86,0,0,0,0,0,ICMPV6,Network,0,6,,,,,
3141,3141,0,fe80::f106:5909:32ae:f4cb,08:00:27:11:4e:fa,08:00:27,0,ff02::1:ffae:f4cb,33:33:ff:ae:f4:cb,33:33:ff,0,58,6,0,0,1901508,2021009,119501,2,172,1901508,2021009,119501,2,172,0,0,0,0,0,ICMPV6,Network,0,6,,,,,
3142,3142,0,fe80::5dd3:6bb3:7720:1e83,08:00:27:52:f4:11,08:00:27,0,ff02::1:ff20:1e83,33:33:ff:20:1e:83,33:33:ff,0,58,6,0,0,2027037,2027037,0,1,86,2027037,2027037,0,1,86,0,0,0,0,0,ICMPV6,Network,0,6,,,,,
3143,3143,0,fe80::5dd3:6bb3:7720:1e83,08:00:27:52:f4:11,08:00:27,0,ff02::1:ff2b:5398,33:33:ff:2b:53:98,33:33:ff,0,58,6,0,0,1903038,2020037,116999,2,172,1903038,2020037,116999,2,172,0,0,0,0,0,ICMPV6,Network,0,6,,,,,
3144,3144,0,fe80::f106:5909:32ae:f4cb,08:00:27:11:4e:fa,08:00:27,0,ff02::1:ff00:4f7,33:33:ff:00:04:f7,33:33:ff,0,58,6,0,0,2020509,2020509,0,1,86,2020509,2020509,0,1,86,0,0,0,0,0,ICMPV6,Network,0,6,,,,,
3153,3153,0,fe80::da58:d7ff:fe00:f72,d8:58:d7:00:0f:72,d8:58:d7,0,ff02::1,33:33:00:00:00:01,33:33:00,0,58,6,0,0,2019647,2145087,125440,3,370,2019647,2145087,125440,3,370,0,0,0,0,0,ICMPV6,Network,0,6,,,,,
3154,3154,0,fe80::5dd3:6bb3:7720:1e83,08:00:27:52:f4:11,08:00:27,0,ff02::1:ff20:1e83,33:33:ff:20:1e:83,33:33:ff,0,58,6,0,0,2148572,2148572,0,1,86,2148572,2148572,0,1,86,0,0,0,0,0,ICMPV6,Network,0,6,,,,,
3156,3156,0,fe80::f106:5909:32ae:f4cb,08:00:27:11:4e:fa,08:00:27,0,ff02::1:ffae:f4cb,33:33:ff:ae:f4:cb,33:33:ff,0,58,6,0,0,2148012,2148012,0,1,86,2148012,2148012,0,1,86,0,0,0,0,0,ICMPV6,Network,0,6,,,,,
3157,3157,0,fe80::f106:5909:32ae:f4cb,08:00:27:11:4e:fa,08:00:27,0,ff02::1:ffcc:1f02,33:33:ff:cc:1f:02,33:33:ff,0,58,6,0,0,2147011,2147011,0,1,86,2147011,2147011,0,1,86,0,0,0,0,0,ICMPV6,Network,0,6,,,,,
3158,3158,0,fe80::5dd3:6bb3:7720:1e83,08:00:27:52:f4:11,08:00:27,0,ff02::1:ff00:2c6,33:33:ff:00:02:c6,33:33:ff,0,58,6,0,0,2147571,2147571,0,1,86,2147571,2147571,0,1,86,0,0,0,0,0,ICMPV6,Network,0,6,,,,,
3159,3159,0,fe80::5dd3:6bb3:7720:1e83,08:00:27:52:f4:11,08:00:27,0,ff02::1:ff2b:5398,33:33:ff:2b:53:98,33:33:ff,0,58,6,0,0,2150074,2150074,0,1,86,2150074,2150074,0,1,86,0,0,0,0,0,ICMPV6,Network,0,6,,,,,
3160,3160,0,fe80::e8ff:97da:2f7f:abb3,08:00:27:38:31:62,08:00:27,0,ff02::1:ff62:aec8,33:33:ff:62:ae:c8,33:33:ff,0,58,6,0,0,2145209,2145209,0,1,86,2145209,2145209,0,1,86,0,0,0,0,0,ICMPV6,Network,0,6,,,,,
3161,3161,0,fe80::e8ff:97da:2f7f:abb3,08:00:27:38:31:62,08:00:27,0,ff02::1:ff00:b30,33:33:ff:00:0b:30,33:33:ff,0,58,6,0,0,2025707,2145209,119502,2,172,2025707,2145209,119502,2,172,0,0,0,0,0,ICMPV6,Network,0,6,,,,,
3162,3162,0,fe80::f106:5909:32ae:f4cb,08:00:27:11:4e:fa,08:00:27,0,ff02::1:ff00:4f7,33:33:ff:00:04:f7,33:33:ff,0,58,6,0,0,2151507,2151507,0,1,86,2151507,2151507,0,1,86,0,0,0,0,0,ICMPV6,Network,0,6,,,,,
3163,3163,0,fe80::e8ff:97da:2f7f:abb3,08:00:27:38:31:62,08:00:27,0,ff02::1:ff7f:abb3,33:33:ff:7f:ab:b3,33:33:ff,0,58,6,0,0,2147713,2147713,0,1,86,2147713,2147713,0,1,86,0,0,0,0,0,ICMPV6,Network,0,6,,,,,
3170,3170,0,192.168.1.168,f4:f5:d8:45:9f:1a,f4:f5:d8,5353,224.0.0.251,01:00:5e:00:00:fb,01:00:5e,5353,17,4,0,0,2008756,2187951,179195,4,1536,2008756,2187951,179195,4,1536,0,0,0,0,0,MDNS,Network,0,6,_googlecast._tcp.local,,,,
3172,3172,0,fe80::da58:d7ff:fe00:f72,d8:58:d7:00:0f:72,d8:58:d7,0,ff02::1,33:33:00:00:00:01,33:33:00,0,58,6,0,0,2270527,2270527,0,1,86,2270527,2270527,0,1,86,0,0,0,0,0,ICMPV6,Network,0,6,,,,,
3173,3173,0,fe80::5dd3:6bb3:7720:1e83,08:00:27:52:f4:11,08:00:27,0,ff02::1:ff2b:5398,33:33:ff:2b:53:98,33:33:ff,0,58,6,0,0,2276065,2276065,0,1,86,2276065,2276065,0,1,86,0,0,0,0,0,ICMPV6,Network,0,6,,,,,
3174,3174,0,fe80::5dd3:6bb3:7720:1e83,08:00:27:52:f4:11,08:00:27,0,ff02::1:ff00:2c6,33:33:ff:00:02:c6,33:33:ff,0,58,6,0,0,2274573,2274573,0,1,86,2274573,2274573,0,1,86,0,0,0,0,0,ICMPV6,Network,0,6,,,,,
3176,3176,0,fe80::f106:5909:32ae:f4cb,08:00:27:11:4e:fa,08:00:27,0,ff02::1:ffae:f4cb,33:33:ff:ae:f4:cb,33:33:ff,0,58,6,0,0,2273011,2273011,0,1,86,2273011,2273011,0,1,86,0,0,0,0,0,ICMPV6,Network,0,6,,,,,
3177,3177,0,fe80::f106:5909:32ae:f4cb,08:00:27:11:4e:fa,08:00:27,0,ff02::1:ff00:4f7,33:33:ff:00:04:f7,33:33:ff,0,58,6,0,0,2277509,2277509,0,1,86,2277509,2277509,0,1,86,0,0,0,0,0,ICMPV6,Network,0,6,,,,,
3178,3178,0,fe80::5dd3:6bb3:7720:1e83,08:00:27:52:f4:11,08:00:27,0,ff02::1:ff20:1e83,33:33:ff:20:1e:83,33:33:ff,0,58,6,0,0,2271569,2271569,0,1,86,2271569,2271569,0,1,86,0,0,0,0,0,ICMPV6,Network,0,6,,,,,
3179,3179,0,fe80::f106:5909:32ae:f4cb,08:00:27:11:4e:fa,08:00:27,0,ff02::1:ffcc:1f02,33:33:ff:cc:1f:02,33:33:ff,0,58,6,0,0,2274504,2274504,0,1,86,2274504,2274504,0,1,86,0,0,0,0,0,ICMPV6,Network,0,6,,,,,
3180,3180,0,fe80::e8ff:97da:2f7f:abb3,08:00:27:38:31:62,08:00:27,0,ff02::1:ff62:aec8,33:33:ff:62:ae:c8,33:33:ff,0,58,6,0,0,2276708,2276708,0,1,86,2276708,2276708,0,1,86,0,0,0,0,0,ICMPV6,Network,0,6,,,,,
3194,3194,0,fe80::da58:d7ff:fe00:f72,d8:58:d7:00:0f:72,d8:58:d7,0,ff02::1,33:33:00:00:00:01,33:33:00,0,58,6,0,0,2395966,2395966,0,1,86,2395966,2395966,0,1,86,0,0,0,0,0,ICMPV6,Network,0,6,,,,,
3195,3195,0,fe80::5dd3:6bb3:7720:1e83,08:00:27:52:f4:11,08:00:27,0,ff02::1:ff2b:5398,33:33:ff:2b:53:98,33:33:ff,0,58,6,0,0,2396067,2396067,0,1,86,2396067,2396067,0,1,86,0,0,0,0,0,ICMPV6,Network,0,6,,,,,
3196,3196,0,fe80::5dd3:6bb3:7720:1e83,08:00:27:52:f4:11,08:00:27,0,ff02::1:ff00:2c6,33:33:ff:00:02:c6,33:33:ff,0,58,6,0,0,2398571,2398571,0,1,86,2398571,2398571,0,1,86,0,0,0,0,0,ICMPV6,Network,0,6,,,,,
3197,3197,0,fe80::e8ff:97da:2f7f:abb3,08:00:27:38:31:62,08:00:27,0,ff02::1:ff7f:abb3,33:33:ff:7f:ab:b3,33:33:ff,0,58,6,0,0,2279211,2396210,116999,2,172,2279211,2396210,116999,2,172,0,0,0,0,0,ICMPV6,Network,0,6,,,,,
3199,3199,0,fe80::5dd3:6bb3:7720:1e83,08:00:27:52:f4:11,08:00:27,0,ff02::1:ff20:1e83,33:33:ff:20:1e:83,33:33:ff,0,58,6,0,0,2403568,2403568,0,1,86,2403568,2403568,0,1,86,0,0,0,0,0,ICMPV6,Network,0,6,,,,,
3200,3200,0,fe80::e8ff:97da:2f7f:abb3,08:00:27:38:31:62,08:00:27,0,ff02::1:ff62:aec8,33:33:ff:62:ae:c8,33:33:ff,0,58,6,0,0,2405213,2405213,0,1,86,2405213,2405213,0,1,86,0,0,0,0,0,ICMPV6,Network,0,6,,,,,
3201,3201,0,fe80::f106:5909:32ae:f4cb,08:00:27:11:4e:fa,08:00:27,0,ff02::1:ffae:f4cb,33:33:ff:ae:f4:cb,33:33:ff,0,58,6,0,0,2400004,2400004,0,1,86,2400004,2400004,0,1,86,0,0,0,0,0,ICMPV6,Network,0,6,,,,,
3202,3202,0,fe80::e8ff:97da:2f7f:abb3,08:00:27:38:31:62,08:00:27,0,ff02::1:ff00:b30,33:33:ff:00:0b:30,33:33:ff,0,58,6,0,0,2276708,2396210,119502,2,172,2276708,2396210,119502,2,172,0,0,0,0,0,ICMPV6,Network,0,6,,,,,
3203,3203,0,fe80::f106:5909:32ae:f4cb,08:00:27:11:4e:fa,08:00:27,0,ff02::1:ff00:4f7,33:33:ff:00:04:f7,33:33:ff,0,58,6,0,0,2402007,2402007,0,1,86,2402007,2402007,0,1,86,0,0,0,0,0,ICMPV6,Network,0,6,,,,,
3210,3210,0,192.168.1.168,f4:f5:d8:45:9f:1a,f4:f5:d8,5353,224.0.0.251,01:00:5e:00:00:fb,01:00:5e,5353,17,4,0,0,2367172,2427983,60811,2,768,2367172,2427983,60811,2,768,0,0,0,0,0,MDNS,Network,0,6,_googlecast._tcp.local,,,,
3215,3215,0,fe80::e8ff:97da:2f7f:abb3,08:00:27:38:31:62,08:00:27,0,ff02::1:ff7f:abb3,33:33:ff:7f:ab:b3,33:33:ff,0,58,6,0,0,2524715,2524715,0,1,86,2524715,2524715,0,1,86,0,0,0,0,0,ICMPV6,Network,0,6,,,,,
3216,3216,0,fe80::5dd3:6bb3:7720:1e83,08:00:27:52:f4:11,08:00:27,0,ff02::1:ff00:2c6,33:33:ff:00:02:c6,33:33:ff,0,58,6,0,0,2522570,2522570,0,1,86,2522570,2522570,0,1,86,0,0,0,0,0,ICMPV6,Network,0,6,,,,,
3217,3217,0,fe80::5dd3:6bb3:7720:1e83,08:00:27:52:f4:11,08:00:27,0,ff02::1:ff2b:5398,33:33:ff:2b:53:98,33:33:ff,0,58,6,0,0,2521568,2521568,0,1,86,2521568,2521568,0,1,86,0,0,0,0,0,ICMPV6,Network,0,6,,,,,
3218,3218,0,fe80::e8ff:97da:2f7f:abb3,08:00:27:38:31:62,08:00:27,0,ff02::1:ff62:aec8,33:33:ff:62:ae:c8,33:33:ff,0,58,6,0,0,2526206,2526206,0,1,86,2526206,2526206,0,1,86,0,0,0,0,0,ICMPV6,Network,0,6,,,,,
3219,3219,0,fe80::f106:5909:32ae:f4cb,08:00:27:11:4e:fa,08:00:27,0,ff02::1:ffcc:1f02,33:33:ff:cc:1f:02,33:33:ff,0,58,6,0,0,2405012,2523512,118500,2,172,2405012,2523512,118500,2,172,0,0,0,0,0,ICMPV6,Network,0,6,,,,,
3220,3220,0,fe80::f106:5909:32ae:f4cb,08:00:27:11:4e:fa,08:00:27,0,ff02::1:ff00:4f7,33:33:ff:00:04:f7,33:33:ff,0,58,6,0,0,2530011,2530011,0,1,86,2530011,2530011,0,1,86,0,0,0,0,0,ICMPV6,Network,0,6,,,,,
3221,3221,0,fe80::5dd3:6bb3:7720:1e83,08:00:27:52:f4:11,08:00:27,0,ff02::1:ff20:1e83,33:33:ff:20:1e:83,33:33:ff,0,58,6,0,0,2525574,2525574,0,1,86,2525574,2525574,0,1,86,0,0,0,0,0,ICMPV6,Network,0,6,,,,,
3236,3236,0,fe80::e8ff:97da:2f7f:abb3,08:00:27:38:31:62,08:00:27,0,ff02::1:ff7f:abb3,33:33:ff:7f:ab:b3,33:33:ff,0,58,6,0,0,2648212,2648212,0,1,86,2648212,2648212,0,1,86,0,0,0,0,0,ICMPV6,Network,0,6,,,,,
3237,3237,0,fe80::5dd3:6bb3:7720:1e83,08:00:27:52:f4:11,08:00:27,0,ff02::1:ff2b:5398,33:33:ff:2b:53:98,33:33:ff,0,58,6,0,0,2652566,2652566,0,1,86,2652566,2652566,0,1,86,0,0,0,0,0,ICMPV6,Network,0,6,,,,,
3238,3238,0,fe80::5dd3:6bb3:7720:1e83,08:00:27:52:f4:11,08:00:27,0,ff02::1:ff00:2c6,33:33:ff:00:02:c6,33:33:ff,0,58,6,0,0,2652065,2652065,0,1,86,2652065,2652065,0,1,86,0,0,0,0,0,ICMPV6,Network,0,6,,,,,
3239,3239,0,fe80::e8ff:97da:2f7f:abb3,08:00:27:38:31:62,08:00:27,0,ff02::1:ff62:aec8,33:33:ff:62:ae:c8,33:33:ff,0,58,6,0,0,2653710,2653710,0,1,86,2653710,2653710,0,1,86,0,0,0,0,0,ICMPV6,Network,0,6,,,,,
3240,3240,0,fe80::f106:5909:32ae:f4cb,08:00:27:11:4e:fa,08:00:27,0,ff02::1:ffae:f4cb,33:33:ff:ae:f4:cb,33:33:ff,0,58,6,0,0,2529511,2647009,117498,2,172,2529511,2647009,117498,2,172,0,0,0,0,0,ICMPV6,Network,0,6,,,,,
3241,3241,0,fe80::f106:5909:32ae:f4cb,08:00:27:11:4e:fa,08:00:27,0,ff02::1:ffcc:1f02,33:33:ff:cc:1f:02,33:33:ff,0,58,6,0,0,2654010,2654010,0,1,86,2654010,2654010,0,1,86,0,0,0,0,0,ICMPV6,Network,0,6,,,,,
3242,3242,0,fe80::5dd3:6bb3:7720:1e83,08:00:27:52:f4:11,08:00:27,0,ff02::1:ff20:1e83,33:33:ff:20:1e:83,33:33:ff,0,58,6,0,0,2655070,2655070,0,1,86,2655070,2655070,0,1,86,0,0,0,0,0,ICMPV6,Network,0,6,,,,,
3243,3243,0,fe80::e8ff:97da:2f7f:abb3,08:00:27:38:31:62,08:00:27,0,ff02::1:ff00:b30,33:33:ff:00:0b:30,33:33:ff,0,58,6,0,0,2529712,2647210,117498,2,172,2529712,2647210,117498,2,172,0,0,0,0,0,ICMPV6,Network,0,6,,,,,
3244,3244,0,192.168.1.166,a4:5e:60:dd:58:1d,a4:5e:60,138,192.168.1.255,ff:ff:ff:ff:ff:ff,ff:ff:ff,138,17,4,0,0,2181561,2181603,42,4,864,2181561,2181603,42,4,864,0,0,0,0,0,NetBIOS.SMBv1,System,0,6,macbookpro-581d,,,,
3253,3253,0,192.168.1.168,f4:f5:d8:45:9f:1a,f4:f5:d8,5353,224.0.0.251,01:00:5e:00:00:fb,01:00:5e,5353,17,4,0,0,2607289,2668115,60826,2,768,2607289,2668115,60826,2,768,0,0,0,0,0,MDNS,Network,0,6,_googlecast._tcp.local,,,,
3259,3259,0,fe80::da58:d7ff:fe00:f72,d8:58:d7:00:0f:72,d8:58:d7,0,ff02::1,33:33:00:00:00:01,33:33:00,0,58,6,0,0,2521406,2772284,250878,5,654,2521406,2772284,250878,5,654,0,0,0,0,0,ICMPV6,Network,0,6,,,,,
3260,3260,0,fe80::e8ff:97da:2f7f:abb3,08:00:27:38:31:62,08:00:27,0,ff02::1:ff62:aec8,33:33:ff:62:ae:c8,33:33:ff,0,58,6,0,0,2773713,2773713,0,1,86,2773713,2773713,0,1,86,0,0,0,0,0,ICMPV6,Network,0,6,,,,,
3261,3261,0,fe80::e8ff:97da:2f7f:abb3,08:00:27:38:31:62,08:00:27,0,ff02::1:ff7f:abb3,33:33:ff:7f:ab:b3,33:33:ff,0,58,6,0,0,2772711,2772711,0,1,86,2772711,2772711,0,1,86,0,0,0,0,0,ICMPV6,Network,0,6,,,,,
3262,3262,0,fe80::5dd3:6bb3:7720:1e83,08:00:27:52:f4:11,08:00:27,0,ff02::1:ff2b:5398,33:33:ff:2b:53:98,33:33:ff,0,58,6,0,0,2773070,2773070,0,1,86,2773070,2773070,0,1,86,0,0,0,0,0,ICMPV6,Network,0,6,,,,,
3263,3263,0,fe80::5dd3:6bb3:7720:1e83,08:00:27:52:f4:11,08:00:27,0,ff02::1:ff00:2c6,33:33:ff:00:02:c6,33:33:ff,0,58,6,0,0,2773570,2773570,0,1,86,2773570,2773570,0,1,86,0,0,0,0,0,ICMPV6,Network,0,6,,,,,
3265,3265,0,fe80::5dd3:6bb3:7720:1e83,08:00:27:52:f4:11,08:00:27,0,ff02::1:ff20:1e83,33:33:ff:20:1e:83,33:33:ff,0,58,6,0,0,2777065,2777065,0,1,86,2777065,2777065,0,1,86,0,0,0,0,0,ICMPV6,Network,0,6,,,,,
3266,3266,0,fe80::f106:5909:32ae:f4cb,08:00:27:11:4e:fa,08:00:27,0,ff02::1:ffae:f4cb,33:33:ff:ae:f4:cb,33:33:ff,0,58,6,0,0,2777007,2777007,0,1,86,2777007,2777007,0,1,86,0,0,0,0,0,ICMPV6,Network,0,6,,,,,
3267,3267,0,fe80::f106:5909:32ae:f4cb,08:00:27:11:4e:fa,08:00:27,0,ff02::1:ff00:4f7,33:33:ff:00:04:f7,33:33:ff,0,58,6,0,0,2655011,2773011,118000,2,172,2655011,2773011,118000,2,172,0,0,0,0,0,ICMPV6,Network,0,6,,,,,
3268,3268,0,fe80::f106:5909:32ae:f4cb,08:00:27:11:4e:fa,08:00:27,0,ff02::1:ffcc:1f02,33:33:ff:cc:1f:02,33:33:ff,0,58,6,0,0,2777007,2777007,0,1,86,2777007,2777007,0,1,86,0,0,0,0,0,ICMPV6,Network,0,6,,,,,
3295,3295,0,fe80::da58:d7ff:fe00:f72,d8:58:d7:00:0f:72,d8:58:d7,0,ff02::1,33:33:00:00:00:01,33:33:00,0,58,6,0,0,2897724,2897724,0,1,86,2897724,2897724,0,1,86,0,0,0,0,0,ICMPV6,Network,0,6,,,,,
3296,3296,0,fe80::e8ff:97da:2f7f:abb3,08:00:27:38:31:62,08:00:27,0,ff02::1:ff7f:abb3,33:33:ff:7f:ab:b3,33:33:ff,0,58,6,0,0,2898713,2898713,0,1,86,2898713,2898713,0,1,86,0,0,0,0,0,ICMPV6,Network,0,6,,,,,
3297,3297,0,fe80::f106:5909:32ae:f4cb,08:00:27:11:4e:fa,08:00:27,0,ff02::1:ffae:f4cb,33:33:ff:ae:f4:cb,33:33:ff,0,58,6,0,0,2900504,2900504,0,1,86,2900504,2900504,0,1,86,0,0,0,0,0,ICMPV6,Network,0,6,,,,,
3298,3298,0,fe80::e8ff:97da:2f7f:abb3,08:00:27:38:31:62,08:00:27,0,ff02::1:ff00:b30,33:33:ff:00:0b:30,33:33:ff,0,58,6,0,0,2780212,2898212,118000,2,172,2780212,2898212,118000,2,172,0,0,0,0,0,ICMPV6,Network,0,6,,,,,
3299,3299,0,fe80::e8ff:97da:2f7f:abb3,08:00:27:38:31:62,08:00:27,0,ff02::1:ff62:aec8,33:33:ff:62:ae:c8,33:33:ff,0,58,6,0,0,2898212,2898212,0,1,86,2898212,2898212,0,1,86,0,0,0,0,0,ICMPV6,Network,0,6,,,,,
3300,3300,0,fe80::f106:5909:32ae:f4cb,08:00:27:11:4e:fa,08:00:27,0,ff02::1:ff00:4f7,33:33:ff:00:04:f7,33:33:ff,0,58,6,0,0,2901005,2901005,0,1,86,2901005,2901005,0,1,86,0,0,0,0,0,ICMPV6,Network,0,6,,,,,
3301,3301,0,fe80::5dd3:6bb3:7720:1e83,08:00:27:52:f4:11,08:00:27,0,ff02::1:ff2b:5398,33:33:ff:2b:53:98,33:33:ff,0,58,6,0,0,2899071,2899071,0,1,86,2899071,2899071,0,1,86,0,0,0,0,0,ICMPV6,Network,0,6,,,,,
3302,3302,0,fe80::5dd3:6bb3:7720:1e83,08:00:27:52:f4:11,08:00:27,0,ff02::1:ff00:2c6,33:33:ff:00:02:c6,33:33:ff,0,58,6,0,0,2899071,2899071,0,1,86,2899071,2899071,0,1,86,0,0,0,0,0,ICMPV6,Network,0,6,,,,,
3303,3303,0,fe80::f106:5909:32ae:f4cb,08:00:27:11:4e:fa,08:00:27,0,ff02::1:ffcc:1f02,33:33:ff:cc:1f:02,33:33:ff,0,58,6,0,0,2905511,2905511,0,1,86,2905511,2905511,0,1,86,0,0,0,0,0,ICMPV6,Network,0,6,,,,,
3304,3304,0,fe80::5dd3:6bb3:7720:1e83,08:00:27:52:f4:11,08:00:27,0,ff02::1:ff20:1e83,33:33:ff:20:1e:83,33:33:ff,0,58,6,0,0,2900072,2900072,0,1,86,2900072,2900072,0,1,86,0,0,0,0,0,ICMPV6,Network,0,6,,,,,
3324,3324,0,fe80::f106:5909:32ae:f4cb,08:00:27:11:4e:fa,08:00:27,0,ff02::1:ffae:f4cb,33:33:ff:ae:f4:cb,33:33:ff,0,58,6,0,0,3024502,3024502,0,1,86,3024502,3024502,0,1,86,0,0,0,0,0,ICMPV6,Network,0,6,,,,,
3325,3325,0,fe80::e8ff:97da:2f7f:abb3,08:00:27:38:31:62,08:00:27,0,ff02::1:ff00:b30,33:33:ff:00:0b:30,33:33:ff,0,58,6,0,0,3024714,3024714,0,1,86,3024714,3024714,0,1,86,0,0,0,0,0,ICMPV6,Network,0,6,,,,,
3326,3326,0,fe80::5dd3:6bb3:7720:1e83,08:00:27:52:f4:11,08:00:27,0,ff02::1:ff20:1e83,33:33:ff:20:1e:83,33:33:ff,0,58,6,0,0,3032072,3032072,0,1,86,3032072,3032072,0,1,86,0,0,0,0,0,ICMPV6,Network,0,6,,,,,
3327,3327,0,fe80::e8ff:97da:2f7f:abb3,08:00:27:38:31:62,08:00:27,0,ff02::1:ff62:aec8,33:33:ff:62:ae:c8,33:33:ff,0,58,6,0,0,3027707,3027707,0,1,86,3027707,3027707,0,1,86,0,0,0,0,0,ICMPV6,Network,0,6,,,,,
3328,3328,0,fe80::e8ff:97da:2f7f:abb3,08:00:27:38:31:62,08:00:27,0,ff02::1:ff7f:abb3,33:33:ff:7f:ab:b3,33:33:ff,0,58,6,0,0,3023712,3023712,0,1,86,3023712,3023712,0,1,86,0,0,0,0,0,ICMPV6,Network,0,6,,,,,
3329,3329,0,fe80::5dd3:6bb3:7720:1e83,08:00:27:52:f4:11,08:00:27,0,ff02::1:ff00:2c6,33:33:ff:00:02:c6,33:33:ff,0,58,6,0,0,3031571,3031571,0,1,86,3031571,3031571,0,1,86,0,0,0,0,0,ICMPV6,Network,0,6,,,,,
3330,3330,0,fe80::f106:5909:32ae:f4cb,08:00:27:11:4e:fa,08:00:27,0,ff02::1:ff00:4f7,33:33:ff:00:04:f7,33:33:ff,0,58,6,0,0,3029509,3029509,0,1,86,3029509,3029509,0,1,86,0,0,0,0,0,ICMPV6,Network,0,6,,,,,
3332,3332,0,fe80::5dd3:6bb3:7720:1e83,08:00:27:52:f4:11,08:00:27,0,ff02::1:ff2b:5398,33:33:ff:2b:53:98,33:33:ff,0,58,6,0,0,3030570,3030570,0,1,86,3030570,3030570,0,1,86,0,0,0,0,0,ICMPV6,Network,0,6,,,,,
3340,3340,0,192.168.1.168,f4:f5:d8:45:9f:1a,f4:f5:d8,5353,224.0.0.251,01:00:5e:00:00:fb,01:00:5e,5353,17,4,0,0,2854281,3027961,173680,3,1152,2854281,3027961,173680,3,1152,0,0,0,0,0,MDNS,Network,0,6,_googlecast._tcp.local,,,,
3341,3341,0,fe80::e8ff:97da:2f7f:abb3,08:00:27:38:31:62,08:00:27,0,ff02::1:ff00:f72,33:33:ff:00:0f:72,33:33:ff,0,58,6,0,0,2882076,2882076,0,1,86,2882076,2882076,0,1,86,0,0,0,0,0,ICMPV6,Network,0,6,,,,,
3344,3344,0,fe80::5dd3:6bb3:7720:1e83,08:00:27:52:f4:11,08:00:27,0,ff02::1:ff00:f72,33:33:ff:00:0f:72,33:33:ff,0,58,6,0,0,2867932,3098587,230655,3,258,2867932,3098587,230655,3,258,0,0,0,0,0,ICMPV6,Network,0,6,,,,,
3347,3347,0,fe80::da58:d7ff:fe00:f72,d8:58:d7:00:0f:72,d8:58:d7,0,ff02::1,33:33:00:00:00:01,33:33:00,0,58,6,0,0,3023163,3148603,125440,3,370,3023163,3148603,125440,3,370,0,0,0,0,0,ICMPV6,Network,0,6,,,,,
3348,3348,0,fe80::5dd3:6bb3:7720:1e83,08:00:27:52:f4:11,08:00:27,0,ff02::1:ff20:1e83,33:33:ff:20:1e:83,33:33:ff,0,58,6,0,0,3154067,3154067,0,1,86,3154067,3154067,0,1,86,0,0,0,0,0,ICMPV6,Network,0,6,,,,,
3349,3349,0,fe80::f106:5909:32ae:f4cb,08:00:27:11:4e:fa,08:00:27,0,ff02::1:ffcc:1f02,33:33:ff:cc:1f:02,33:33:ff,0,58,6,0,0,3032003,3150003,118000,2,172,3032003,3150003,118000,2,172,0,0,0,0,0,ICMPV6,Network,0,6,,,,,
3350,3350,0,fe80::f106:5909:32ae:f4cb,08:00:27:11:4e:fa,08:00:27,0,ff02::1:ff00:4f7,33:33:ff:00:04:f7,33:33:ff,0,58,6,0,0,3157504,3157504,0,1,86,3157504,3157504,0,1,86,0,0,0,0,0,ICMPV6,Network,0,6,,,,,
3351,3351,0,fe80::e8ff:97da:2f7f:abb3,08:00:27:38:31:62,08:00:27,0,ff02::1:ff62:aec8,33:33:ff:62:ae:c8,33:33:ff,0,58,6,0,0,3154210,3154210,0,1,86,3154210,3154210,0,1,86,0,0,0,0,0,ICMPV6,Network,0,6,,,,,
3352,3352,0,fe80::e8ff:97da:2f7f:abb3,08:00:27:38:31:62,08:00:27,0,ff02::1:ff00:b30,33:33:ff:00:0b:30,33:33:ff,0,58,6,0,0,3152708,3152708,0,1,86,3152708,3152708,0,1,86,0,0,0,0,0,ICMPV6,Network,0,6,,,,,
3353,3353,0,fe80::5dd3:6bb3:7720:1e83,08:00:27:52:f4:11,08:00:27,0,ff02::1:ff00:2c6,33:33:ff:00:02:c6,33:33:ff,0,58,6,0,0,3157072,3157072,0,1,86,3157072,3157072,0,1,86,0,0,0,0,0,ICMPV6,Network,0,6,,,,,
3354,3354,0,fe80::e8ff:97da:2f7f:abb3,08:00:27:38:31:62,08:00:27,0,ff02::1:ff7f:abb3,33:33:ff:7f:ab:b3,33:33:ff,0,58,6,0,0,3154710,3154710,0,1,86,3154710,3154710,0,1,86,0,0,0,0,0,ICMPV6,Network,0,6,,,,,
3355,3355,0,fe80::f106:5909:32ae:f4cb,08:00:27:11:4e:fa,08:00:27,0,ff02::1:ffae:f4cb,33:33:ff:ae:f4:cb,33:33:ff,0,58,6,0,0,3152006,3152006,0,1,86,3152006,3152006,0,1,86,0,0,0,0,0,ICMPV6,Network,0,6,,,,,
3356,3356,0,fe80::5dd3:6bb3:7720:1e83,08:00:27:52:f4:11,08:00:27,0,ff02::1:ff2b:5398,33:33:ff:2b:53:98,33:33:ff,0,58,6,0,0,3158073,3158073,0,1,86,3158073,3158073,0,1,86,0,0,0,0,0,ICMPV6,Network,0,6,,,,,
3375,3375,0,192.168.1.166,a4:5e:60:dd:58:1d,a4:5e:60,138,192.168.1.255,ff:ff:ff:ff:ff:ff,ff:ff:ff,138,17,4,0,0,2781592,2781593,1,3,648,2781592,2781593,1,3,648,0,0,0,0,0,NetBIOS.SMBv1,System,0,6,macbookpro-581d,,,,
3377,3377,0,fe80::e8ff:97da:2f7f:abb3,08:00:27:38:31:62,08:00:27,0,ff02::1:ff7f:abb3,33:33:ff:7f:ab:b3,33:33:ff,0,58,6,0,0,3278709,3278709,0,1,86,3278709,3278709,0,1,86,0,0,0,0,0,ICMPV6,Network,0,6,,,,,
3378,3378,0,fe80::f106:5909:32ae:f4cb,08:00:27:11:4e:fa,08:00:27,0,ff02::1:ffae:f4cb,33:33:ff:ae:f4:cb,33:33:ff,0,58,6,0,0,3280010,3280010,0,1,86,3280010,3280010,0,1,86,0,0,0,0,0,ICMPV6,Network,0,6,,,,,
3379,3379,0,fe80::f106:5909:32ae:f4cb,08:00:27:11:4e:fa,08:00:27,0,ff02::1:ff00:4f7,33:33:ff:00:04:f7,33:33:ff,0,58,6,0,0,3277506,3277506,0,1,86,3277506,3277506,0,1,86,0,0,0,0,0,ICMPV6,Network,0,6,,,,,
3380,3380,0,fe80::5dd3:6bb3:7720:1e83,08:00:27:52:f4:11,08:00:27,0,ff02::1:ff20:1e83,33:33:ff:20:1e:83,33:33:ff,0,58,6,0,0,3274070,3274070,0,1,86,3274070,3274070,0,1,86,0,0,0,0,0,ICMPV6,Network,0,6,,,,,
3381,3381,0,fe80::e8ff:97da:2f7f:abb3,08:00:27:38:31:62,08:00:27,0,ff02::1:ff62:aec8,33:33:ff:62:ae:c8,33:33:ff,0,58,6,0,0,3277707,3277707,0,1,86,3277707,3277707,0,1,86,0,0,0,0,0,ICMPV6,Network,0,6,,,,,
3382,3382,0,fe80::5dd3:6bb3:7720:1e83,08:00:27:52:f4:11,08:00:27,0,ff02::1:ff2b:5398,33:33:ff:2b:53:98,33:33:ff,0,58,6,0,0,3281070,3281070,0,1,86,3281070,3281070,0,1,86,0,0,0,0,0,ICMPV6,Network,0,6,,,,,
3383,3383,0,fe80::f106:5909:32ae:f4cb,08:00:27:11:4e:fa,08:00:27,0,ff02::1:ffcc:1f02,33:33:ff:cc:1f:02,33:33:ff,0,58,6,0,0,3274512,3274512,0,1,86,3274512,3274512,0,1,86,0,0,0,0,0,ICMPV6,Network,0,6,,,,,
3384,3384,0,fe80::5dd3:6bb3:7720:1e83,08:00:27:52:f4:11,08:00:27,0,ff02::1:ff00:2c6,33:33:ff:00:02:c6,33:33:ff,0,58,6,0,0,3278566,3278566,0,1,86,3278566,3278566,0,1,86,0,0,0,0,0,ICMPV6,Network,0,6,,,,,
3385,3385,0,fe80::e8ff:97da:2f7f:abb3,08:00:27:38:31:62,08:00:27,0,ff02::1:ff00:b30,33:33:ff:00:0b:30,33:33:ff,0,58,6,0,0,3278208,3278208,0,1,86,3278208,3278208,0,1,86,0,0,0,0,0,ICMPV6,Network,0,6,,,,,
3386,3386,0,fe80::5dd3:6bb3:7720:1e83,08:00:27:52:f4:11,08:00:27,0,ff02::1:ff00:f72,33:33:ff:00:0f:72,33:33:ff,0,58,6,0,0,3244475,3244475,0,1,86,3244475,3244475,0,1,86,0,0,0,0,0,ICMPV6,Network,0,6,,,,,
3394,3394,0,192.168.1.168,f4:f5:d8:45:9f:1a,f4:f5:d8,5353,224.0.0.251,01:00:5e:00:00:fb,01:00:5e,5353,17,4,0,0,3208393,3268091,59698,2,768,3208393,3268091,59698,2,768,0,0,0,0,0,MDNS,Network,0,6,_googlecast._tcp.local,,,,
3402,3402,0,fe80::e8ff:97da:2f7f:abb3,08:00:27:38:31:62,08:00:27,0,ff02::1:ff00:f72,33:33:ff:00:0f:72,33:33:ff,0,58,6,0,0,3218507,3318218,99711,2,172,3218507,3318218,99711,2,172,0,0,0,0,0,ICMPV6,Network,0,6,,,,,
3408,3408,0,fe80::da58:d7ff:fe00:f72,d8:58:d7:00:0f:72,d8:58:d7,0,ff02::1,33:33:00:00:00:01,33:33:00,0,58,6,0,0,3274042,3399482,125440,3,370,3274042,3399482,125440,3,370,0,0,0,0,0,ICMPV6,Network,0,6,,,,,
3409,3409,0,fe80::f106:5909:32ae:f4cb,08:00:27:11:4e:fa,08:00:27,0,ff02::1:ffae:f4cb,33:33:ff:ae:f4:cb,33:33:ff,0,58,6,0,0,3402005,3402005,0,1,86,3402005,3402005,0,1,86,0,0,0,0,0,ICMPV6,Network,0,6,,,,,
3410,3410,0,fe80::e8ff:97da:2f7f:abb3,08:00:27:38:31:62,08:00:27,0,ff02::1:ff7f:abb3,33:33:ff:7f:ab:b3,33:33:ff,0,58,6,0,0,3401214,3401214,0,1,86,3401214,3401214,0,1,86,0,0,0,0,0,ICMPV6,Network,0,6,,,,,
3412,3412,0,fe80::f106:5909:32ae:f4cb,08:00:27:11:4e:fa,08:00:27,0,ff02::1:ff00:4f7,33:33:ff:00:04:f7,33:33:ff,0,58,6,0,0,3402506,3402506,0,1,86,3402506,3402506,0,1,86,0,0,0,0,0,ICMPV6,Network,0,6,,,,,
3413,3413,0,fe80::5dd3:6bb3:7720:1e83,08:00:27:52:f4:11,08:00:27,0,ff02::1:ff20:1e83,33:33:ff:20:1e:83,33:33:ff,0,58,6,0,0,3403065,3403065,0,1,86,3403065,3403065,0,1,86,0,0,0,0,0,ICMPV6,Network,0,6,,,,,
3414,3414,0,fe80::5dd3:6bb3:7720:1e83,08:00:27:52:f4:11,08:00:27,0,ff02::1:ff2b:5398,33:33:ff:2b:53:98,33:33:ff,0,58,6,0,0,3405569,3405569,0,1,86,3405569,3405569,0,1,86,0,0,0,0,0,ICMPV6,Network,0,6,,,,,
3415,3415,0,fe80::5dd3:6bb3:7720:1e83,08:00:27:52:f4:11,08:00:27,0,ff02::1:ff00:2c6,33:33:ff:00:02:c6,33:33:ff,0,58,6,0,0,3407071,3407071,0,1,86,3407071,3407071,0,1,86,0,0,0,0,0,ICMPV6,Network,0,6,,,,,
3416,3416,0,fe80::e8ff:97da:2f7f:abb3,08:00:27:38:31:62,08:00:27,0,ff02::1:ff00:b30,33:33:ff:00:0b:30,33:33:ff,0,58,6,0,0,3408716,3408716,0,1,86,3408716,3408716,0,1,86,0,0,0,0,0,ICMPV6,Network,0,6,,,,,
3417,3417,0,fe80::f106:5909:32ae:f4cb,08:00:27:11:4e:fa,08:00:27,0,ff02::1:ffcc:1f02,33:33:ff:cc:1f:02,33:33:ff,0,58,6,0,0,3406011,3406011,0,1,86,3406011,3406011,0,1,86,0,0,0,0,0,ICMPV6,Network,0,6,,,,,
3419,3419,0,fe80::e8ff:97da:2f7f:abb3,08:00:27:38:31:62,08:00:27,0,ff02::1:ff62:aec8,33:33:ff:62:ae:c8,33:33:ff,0,58,6,0,0,3403708,3403708,0,1,86,3403708,3403708,0,1,86,0,0,0,0,0,ICMPV6,Network,0,6,,,,,
3719,3719,0,fe80::da58:d7ff:fe00:f72,d8:58:d7:00:0f:72,d8:58:d7,0,ff02::1,33:33:00:00:00:01,33:33:00,0,58,6,0,0,3524921,3524921,0,1,86,3524921,3524921,0,1,86,0,0,0,0,0,ICMPV6,Network,0,6,,,,,
3720,3720,0,fe80::5dd3:6bb3:7720:1e83,08:00:27:52:f4:11,08:00:27,0,ff02::1:ff2b:5398,33:33:ff:2b:53:98,33:33:ff,0,58,6,0,0,3529067,3529067,0,1,86,3529067,3529067,0,1,86,0,0,0,0,0,ICMPV6,Network,0,6,,,,,
3721,3721,0,fe80::5dd3:6bb3:7720:1e83,08:00:27:52:f4:11,08:00:27,0,ff02::1:ff00:2c6,33:33:ff:00:02:c6,33:33:ff,0,58,6,0,0,3529567,3529567,0,1,86,3529567,3529567,0,1,86,0,0,0,0,0,ICMPV6,Network,0,6,,,,,
3722,3722,0,fe80::e8ff:97da:2f7f:abb3,08:00:27:38:31:62,08:00:27,0,ff02::1:ff00:b30,33:33:ff:00:0b:30,33:33:ff,0,58,6,0,0,3531212,3531212,0,1,86,3531212,3531212,0,1,86,0,0,0,0,0,ICMPV6,Network,0,6,,,,,
3725,3725,0,fe80::e8ff:97da:2f7f:abb3,08:00:27:38:31:62,08:00:27,0,ff02::1:ff7f:abb3,33:33:ff:7f:ab:b3,33:33:ff,0,58,6,0,0,3525714,3525714,0,1,86,3525714,3525714,0,1,86,0,0,0,0,0,ICMPV6,Network,0,6,,,,,
3726,3726,0,fe80::5dd3:6bb3:7720:1e83,08:00:27:52:f4:11,08:00:27,0,ff02::1:ff20:1e83,33:33:ff:20:1e:83,33:33:ff,0,58,6,0,0,3529067,3529067,0,1,86,3529067,3529067,0,1,86,0,0,0,0,0,ICMPV6,Network,0,6,,,,,
3727,3727,0,fe80::e8ff:97da:2f7f:abb3,08:00:27:38:31:62,08:00:27,0,ff02::1:ff62:aec8,33:33:ff:62:ae:c8,33:33:ff,0,58,6,0,0,3533715,3533715,0,1,86,3533715,3533715,0,1,86,0,0,0,0,0,ICMPV6,Network,0,6,,,,,
3728,3728,0,fe80::f106:5909:32ae:f4cb,08:00:27:11:4e:fa,08:00:27,0,ff02::1:ffcc:1f02,33:33:ff:cc:1f:02,33:33:ff,0,58,6,0,0,3531511,3531511,0,1,86,3531511,3531511,0,1,86,0,0,0,0,0,ICMPV6,Network,0,6,,,,,
3729,3729,0,fe80::f106:5909:32ae:f4cb,08:00:27:11:4e:fa,08:00:27,0,ff02::1:ffae:f4cb,33:33:ff:ae:f4:cb,33:33:ff,0,58,6,0,0,3525012,3525012,0,1,86,3525012,3525012,0,1,86,0,0,0,0,0,ICMPV6,Network,0,6,,,,,
3730,3730,0,fe80::f106:5909:32ae:f4cb,08:00:27:11:4e:fa,08:00:27,0,ff02::1:ff00:4f7,33:33:ff:00:04:f7,33:33:ff,0,58,6,0,0,3528006,3528006,0,1,86,3528006,3528006,0,1,86,0,0,0,0,0,ICMPV6,Network,0,6,,,,,
3741,3741,0,fe80::5dd3:6bb3:7720:1e83,08:00:27:52:f4:11,08:00:27,0,ff02::1:ff00:f72,33:33:ff:00:0f:72,33:33:ff,0,58,6,0,0,3409386,3518842,109456,2,172,3409386,3518842,109456,2,172,0,0,0,0,0,ICMPV6,Network,0,6,,,,,
3757,3757,0,fe80::da58:d7ff:fe00:f72,d8:58:d7:00:0f:72,d8:58:d7,0,ff02::1,33:33:00:00:00:01,33:33:00,0,58,6,0,0,3650361,3668737,18376,5,430,3650361,3668737,18376,5,430,0,0,0,0,0,ICMPV6,Network,0,6,,,,,
3759,3759,0,fe80::5dd3:6bb3:7720:1e83,08:00:27:52:f4:11,08:00:27,0,ff02::1:ff20:1e83,33:33:ff:20:1e:83,33:33:ff,0,58,6,0,0,3655067,3673564,18497,3,258,3655067,3673564,18497,3,258,0,0,0,0,0,ICMPV6,Network,0,6,,,,,
3760,3760,0,fe80::e8ff:97da:2f7f:abb3,08:00:27:38:31:62,08:00:27,0,ff02::1:ff62:aec8,33:33:ff:62:ae:c8,33:33:ff,0,58,6,0,0,3655210,3669210,14000,2,172,3655210,3669210,14000,2,172,0,0,0,0,0,ICMPV6,Network,0,6,,,,,
3761,3761,0,fe80::5dd3:6bb3:7720:1e83,08:00:27:52:f4:11,08:00:27,0,ff02::1:ff00:2c6,33:33:ff:00:02:c6,33:33:ff,0,58,6,0,0,3651072,3673073,22001,2,172,3651072,3673073,22001,2,172,0,0,0,0,0,ICMPV6,Network,0,6,,,,,
3762,3762,0,fe80::f106:5909:32ae:f4cb,08:00:27:11:4e:fa,08:00:27,0,ff02::1:ffae:f4cb,33:33:ff:ae:f4:cb,33:33:ff,0,58,6,0,0,3658504,3677010,18506,3,258,3658504,3677010,18506,3,258,0,0,0,0,0,ICMPV6,Network,0,6,,,,,
3763,3763,0,fe80::f106:5909:32ae:f4cb,08:00:27:11:4e:fa,08:00:27,0,ff02::1:ff00:4f7,33:33:ff:00:04:f7,33:33:ff,0,58,6,0,0,3659005,3678013,19008,3,258,3659005,3678013,19008,3,258,0,0,0,0,0,ICMPV6,Network,0,6,,,,,
3764,3764,0,fe80::e8ff:97da:2f7f:abb3,08:00:27:38:31:62,08:00:27,0,ff02::1:ff00:b30,33:33:ff:00:0b:30,33:33:ff,0,58,6,0,0,3653207,3677212,24005,3,258,3653207,3677212,24005,3,258,0,0,0,0,0,ICMPV6,Network,0,6,,,,,
3765,3765,0,fe80::5dd3:6bb3:7720:1e83,08:00:27:52:f4:11,08:00:27,0,ff02::1:ff2b:5398,33:33:ff:2b:53:98,33:33:ff,0,58,6,0,0,3651072,3674566,23494,2,172,3651072,3674566,23494,2,172,0,0,0,0,0,ICMPV6,Network,0,6,,,,,
3766,3766,0,fe80::f106:5909:32ae:f4cb,08:00:27:11:4e:fa,08:00:27,0,ff02::1:ffcc:1f02,33:33:ff:cc:1f:02,33:33:ff,0,58,6,0,0,3657503,3674507,17004,2,172,3657503,3674507,17004,2,172,0,0,0,0,0,ICMPV6,Network,0,6,,,,,
3768,3768,0,192.168.1.168,f4:f5:d8:45:9f:1a,f4:f5:d8,5353,224.0.0.251,01:00:5e:00:00:fb,01:00:5e,5353,17,4,0,0,3448114,3628135,180021,4,1345,3448114,3628135,180021,4,1345,0,0,0,0,0,MDNS,Network,0,6,_googlecast._tcp.local,,,,
3771,3771,0,192.168.1.166,a4:5e:60:dd:58:1d,a4:5e:60,138,192.168.1.255,ff:ff:ff:ff:ff:ff,ff:ff:ff,138,17,4,0,0,3381608,3554994,173386,13,2808,3381608,3554994,173386,13,2808,0,0,0,0,0,NetBIOS.SMBv1,System,0,6,macbookpro-581d,,,,
4563,4563,0,192.168.1.141,00:b3:62:2b:d9:ad,00:b3:62,5353,224.0.0.251,01:00:5e:00:00:fb,01:00:5e,5353,17,4,0,0,2480562,2480562,0,1,83,2480562,2480562,0,1,83,0,0,0,0,0,MDNS,Network,0,6,_sleep-proxy._udp.local,,,,
6110,6110,0,192.168.1.166,a4:5e:60:dd:58:1d,a4:5e:60,137,192.168.1.255,ff:ff:ff:ff:ff:ff,ff:ff:ff,137,17,4,0,0,3381608,3451515,69907,3,276,3381608,3451515,69907,3,276,0,0,0,0,0,NetBIOS,System,0,6,__msbrowse__,,,,
6294,6294,0,fe80::e8ff:97da:2f7f:abb3,08:00:27:38:31:62,08:00:27,0,ff02::1:ff00:f72,33:33:ff:00:0f:72,33:33:ff,0,58,6,0,0,3489850,3489850,0,1,86,3489850,3489850,0,1,86,0,0,0,0,0,ICMPV6,Network,0,6,,,,,
6539,6539,0,fe80::e8ff:97da:2f7f:abb3,08:00:27:38:31:62,08:00:27,0,ff02::1:ff7f:abb3,33:33:ff:7f:ab:b3,33:33:ff,0,58,6,0,0,3654709,3796713,142004,4,344,3654709,3796713,142004,4,344,0,0,0,0,0,ICMPV6,Network,0,6,,,,,
6540,6540,0,fe80::e8ff:97da:2f7f:abb3,08:00:27:38:31:62,08:00:27,0,ff02::1:ff00:b30,33:33:ff:00:0b:30,33:33:ff,0,58,6,0,0,3799708,3799708,0,1,86,3799708,3799708,0,1,86,0,0,0,0,0,ICMPV6,Network,0,6,,,,,
6541,6541,0,fe80::e8ff:97da:2f7f:abb3,08:00:27:38:31:62,08:00:27,0,ff02::1:ff62:aec8,33:33:ff:62:ae:c8,33:33:ff,0,58,6,0,0,3794711,3794711,0,1,86,3794711,3794711,0,1,86,0,0,0,0,0,ICMPV6,Network,0,6,,,,,
6542,6542,0,fe80::f106:5909:32ae:f4cb,08:00:27:11:4e:fa,08:00:27,0,ff02::1:ffae:f4cb,33:33:ff:ae:f4:cb,33:33:ff,0,58,6,0,0,3798004,3798004,0,1,86,3798004,3798004,0,1,86,0,0,0,0,0,ICMPV6,Network,0,6,,,,,
6543,6543,0,fe80::5dd3:6bb3:7720:1e83,08:00:27:52:f4:11,08:00:27,0,ff02::1:ff00:2c6,33:33:ff:00:02:c6,33:33:ff,0,58,6,0,0,3797573,3797573,0,1,86,3797573,3797573,0,1,86,0,0,0,0,0,ICMPV6,Network,0,6,,,,,
6544,6544,0,fe80::f106:5909:32ae:f4cb,08:00:27:11:4e:fa,08:00:27,0,ff02::1:ff00:4f7,33:33:ff:00:04:f7,33:33:ff,0,58,6,0,0,3799006,3799006,0,1,86,3799006,3799006,0,1,86,0,0,0,0,0,ICMPV6,Network,0,6,,,,,
6545,6545,0,fe80::5dd3:6bb3:7720:1e83,08:00:27:52:f4:11,08:00:27,0,ff02::1:ff20:1e83,33:33:ff:20:1e:83,33:33:ff,0,58,6,0,0,3794568,3794568,0,1,86,3794568,3794568,0,1,86,0,0,0,0,0,ICMPV6,Network,0,6,,,,,
6546,6546,0,fe80::5dd3:6bb3:7720:1e83,08:00:27:52:f4:11,08:00:27,0,ff02::1:ff2b:5398,33:33:ff:2b:53:98,33:33:ff,0,58,6,0,0,3800567,3800567,0,1,86,3800567,3800567,0,1,86,0,0,0,0,0,ICMPV6,Network,0,6,,,,,
6547,6547,0,fe80::f106:5909:32ae:f4cb,08:00:27:11:4e:fa,08:00:27,0,ff02::1:ffcc:1f02,33:33:ff:cc:1f:02,33:33:ff,0,58,6,0,0,3802511,3802511,0,1,86,3802511,3802511,0,1,86,0,0,0,0,0,ICMPV6,Network,0,6,,,,,
6551,6551,0,192.168.1.166,a4:5e:60:dd:58:1d,a4:5e:60,138,192.168.1.255,ff:ff:ff:ff:ff:ff,ff:ff:ff,138,17,4,0,0,3824578,3824578,0,3,648,3824578,3824578,0,3,648,0,0,0,0,0,NetBIOS.SMBv1,System,0,6,macbookpro-581d,,,,
6552,6552,0,fe80::da58:d7ff:fe00:f72,d8:58:d7:00:0f:72,d8:58:d7,0,ff02::1,33:33:00:00:00:01,33:33:00,0,58,6,0,0,3793976,3919160,125184,3,370,3793976,3919160,125184,3,370,0,0,0,0,0,ICMPV6,Network,0,6,,,,,
6553,6553,0,fe80::e8ff:97da:2f7f:abb3,08:00:27:38:31:62,08:00:27,0,ff02::1:ff7f:abb3,33:33:ff:7f:ab:b3,33:33:ff,0,58,6,0,0,3919210,3919210,0,1,86,3919210,3919210,0,1,86,0,0,0,0,0,ICMPV6,Network,0,6,,,,,
6556,6556,0,fe80::5dd3:6bb3:7720:1e83,08:00:27:52:f4:11,08:00:27,0,ff02::1:ff2b:5398,33:33:ff:2b:53:98,33:33:ff,0,58,6,0,0,3926568,3926568,0,1,86,3926568,3926568,0,1,86,0,0,0,0,0,ICMPV6,Network,0,6,,,,,
6557,6557,0,fe80::f106:5909:32ae:f4cb,08:00:27:11:4e:fa,08:00:27,0,ff02::1:ff00:4f7,33:33:ff:00:04:f7,33:33:ff,0,58,6,0,0,3924006,3924006,0,1,86,3924006,3924006,0,1,86,0,0,0,0,0,ICMPV6,Network,0,6,,,,,
6558,6558,0,fe80::f106:5909:32ae:f4cb,08:00:27:11:4e:fa,08:00:27,0,ff02::1:ffae:f4cb,33:33:ff:ae:f4:cb,33:33:ff,0,58,6,0,0,3923004,3923004,0,1,86,3923004,3923004,0,1,86,0,0,0,0,0,ICMPV6,Network,0,6,,,,,
6559,6559,0,fe80::5dd3:6bb3:7720:1e83,08:00:27:52:f4:11,08:00:27,0,ff02::1:ff00:2c6,33:33:ff:00:02:c6,33:33:ff,0,58,6,0,0,3923073,3923073,0,1,86,3923073,3923073,0,1,86,0,0,0,0,0,ICMPV6,Network,0,6,,,,,
6560,6560,0,fe80::e8ff:97da:2f7f:abb3,08:00:27:38:31:62,08:00:27,0,ff02::1:ff00:b30,33:33:ff:00:0b:30,33:33:ff,0,58,6,0,0,3922214,3922214,0,1,86,3922214,3922214,0,1,86,0,0,0,0,0,ICMPV6,Network,0,6,,,,,
6561,6561,0,fe80::e8ff:97da:2f7f:abb3,08:00:27:38:31:62,08:00:27,0,ff02::1:ff62:aec8,33:33:ff:62:ae:c8,33:33:ff,0,58,6,0,0,3922715,3922715,0,1,86,3922715,3922715,0,1,86,0,0,0,0,0,ICMPV6,Network,0,6,,,,,
6565,6565,0,::,08:00:27:11:4e:fa,08:00:27,0,ff02::1:ff00:b30,33:33:ff:00:0b:30,33:33:ff,0,58,6,0,0,3666506,3666506,0,1,78,3666506,3666506,0,1,78,0,0,0,0,0,ICMPV6,Network,0,6,,,,,
6566,6566,0,fd2d:ab8c:225::b30,08:00:27:38:31:62,08:00:27,0,ff02::1,33:33:00:00:00:01,33:33:00,0,58,6,0,0,3666506,3666506,0,1,86,3666506,3666506,0,1,86,0,0,0,0,0,ICMPV6,Network,0,6,,,,,
6567,6567,0,::,08:00:27:11:4e:fa,08:00:27,0,ff02::1:ff00:4f7,33:33:ff:00:04:f7,33:33:ff,0,58,6,0,0,3678012,3678012,0,1,78,3678012,3678012,0,1,78,0,0,0,0,0,ICMPV6,Network,0,6,,,,,
6580,6580,0,fe80::da58:d7ff:fe00:f72,d8:58:d7:00:0f:72,d8:58:d7,0,ff02::1,33:33:00:00:00:01,33:33:00,0,58,6,0,0,4044600,4124503,79903,6,516,4044600,4124503,79903,6,516,0,0,0,0,0,ICMPV6,Network,0,6,,,,,
6581,6581,0,fe80::e8ff:97da:2f7f:abb3,08:00:27:38:31:62,08:00:27,0,ff02::1:ff62:aec8,33:33:ff:62:ae:c8,33:33:ff,0,58,6,0,0,4052210,4124735,72525,3,258,4052210,4124735,72525,3,258,0,0,0,0,0,ICMPV6,Network,0,6,,,,,
6582,6582,0,fe80::5dd3:6bb3:7720:1e83,08:00:27:52:f4:11,08:00:27,0,ff02::1:ff20:1e83,33:33:ff:20:1e:83,33:33:ff,0,58,6,0,0,3925566,4131072,205506,4,344,3925566,4131072,205506,4,344,0,0,0,0,0,ICMPV6,Network,0,6,,,,,
6583,6583,0,fe80::f106:5909:32ae:f4cb,08:00:27:11:4e:fa,08:00:27,0,ff02::1:ff00:4f7,33:33:ff:00:04:f7,33:33:ff,0,58,6,0,0,4050007,4129515,79508,4,344,4050007,4129515,79508,4,344,0,0,0,0,0,ICMPV6,Network,0,6,,,,,
6584,6584,0,fe80::5dd3:6bb3:7720:1e83,08:00:27:52:f4:11,08:00:27,0,ff02::1:ff2b:5398,33:33:ff:2b:53:98,33:33:ff,0,58,6,0,0,4049565,4131072,81507,3,258,4049565,4131072,81507,3,258,0,0,0,0,0,ICMPV6,Network,0,6,,,,,
6585,6585,0,fe80::e1ff:dec7:bebd:f5d0,08:00:27:5e:a3:27,08:00:27,0,ff02::1:ff00:994,33:33:ff:00:09:94,33:33:ff,0,58,6,0,0,4133513,4133777,264,2,172,4133513,4133777,264,2,172,0,0,0,0,0,ICMPV6,Network,0,6,,,,,
6586,6586,0,fe80::5dd3:6bb3:7720:1e83,08:00:27:52:f4:11,08:00:27,0,ff02::1:ff00:2c6,33:33:ff:00:02:c6,33:33:ff,0,58,6,0,0,4051568,4127066,75498,4,344,4051568,4127066,75498,4,344,0,0,0,0,0,ICMPV6,Network,0,6,,,,,
6587,6587,0,fe80::e8ff:97da:2f7f:abb3,08:00:27:38:31:62,08:00:27,0,ff02::1:ff00:b30,33:33:ff:00:0b:30,33:33:ff,0,58,6,0,0,4051710,4132727,81017,4,344,4051710,4132727,81017,4,344,0,0,0,0,0,ICMPV6,Network,0,6,,,,,
6588,6588,0,fe80::f106:5909:32ae:f4cb,08:00:27:11:4e:fa,08:00:27,0,ff02::1:ffae:f4cb,33:33:ff:ae:f4:cb,33:33:ff,0,58,6,0,0,4050508,4131003,80495,3,258,4050508,4131003,80495,3,258,0,0,0,0,0,ICMPV6,Network,0,6,,,,,
6589,6589,0,fe80::e8ff:97da:2f7f:abb3,08:00:27:38:31:62,08:00:27,0,ff02::1:ff7f:abb3,33:33:ff:7f:ab:b3,33:33:ff,0,58,6,0,0,4047714,4130233,82519,3,258,4047714,4130233,82519,3,258,0,0,0,0,0,ICMPV6,Network,0,6,,,,,
6590,6590,0,fe80::e1ff:dec7:bebd:f5d0,08:00:27:5e:a3:27,08:00:27,0,ff02::1:ffbd:f5d0,33:33:ff:bd:f5:d0,33:33:ff,0,58,6,0,0,4108284,4126776,18492,4,344,4108284,4126776,18492,4,344,0,0,0,0,0,ICMPV6,Network,0,6,,,,,
6591,6591,0,fe80::e1ff:dec7:bebd:f5d0,08:00:27:5e:a3:27,08:00:27,0,ff02::1:ffb4:4877,33:33:ff:b4:48:77,33:33:ff,0,58,6,0,0,4108284,4129781,21497,4,344,4108284,4129781,21497,4,344,0,0,0,0,0,ICMPV6,Network,0,6,,,,,
6603,6603,0,fe80::da58:d7ff:fe00:f72,d8:58:d7:00:0f:72,d8:58:d7,0,ff02::1,33:33:00:00:00:01,33:33:00,0,58,6,0,0,4249911,4249911,0,1,86,4249911,4249911,0,1,86,0,0,0,0,0,ICMPV6,Network,0,6,,,,,
6604,6604,0,fe80::f106:5909:32ae:f4cb,08:00:27:11:4e:fa,08:00:27,0,ff02::1:ffcc:1f02,33:33:ff:cc:1f:02,33:33:ff,0,58,6,0,0,3928011,4251527,323516,5,430,3928011,4251527,323516,5,430,0,0,0,0,0,ICMPV6,Network,0,6,,,,,
6605,6605,0,fe80::f106:5909:32ae:f4cb,08:00:27:11:4e:fa,08:00:27,0,ff02::1:ff00:4f7,33:33:ff:00:04:f7,33:33:ff,0,58,6,0,0,4252528,4252528,0,1,86,4252528,4252528,0,1,86,0,0,0,0,0,ICMPV6,Network,0,6,,,,,
6608,6608,0,fe80::5dd3:6bb3:7720:1e83,08:00:27:52:f4:11,08:00:27,0,ff02::1:ff20:1e83,33:33:ff:20:1e:83,33:33:ff,0,58,6,0,0,4251625,4251625,0,1,86,4251625,4251625,0,1,86,0,0,0,0,0,ICMPV6,Network,0,6,,,,,
6609,6609,0,fe80::e1ff:dec7:bebd:f5d0,08:00:27:5e:a3:27,08:00:27,0,ff02::1:ffb4:4877,33:33:ff:b4:48:77,33:33:ff,0,58,6,0,0,4259277,4259277,0,1,86,4259277,4259277,0,1,86,0,0,0,0,0,ICMPV6,Network,0,6,,,,,
6610,6610,0,fe80::e8ff:97da:2f7f:abb3,08:00:27:38:31:62,08:00:27,0,ff02::1:ff00:b30,33:33:ff:00:0b:30,33:33:ff,0,58,6,0,0,4257731,4257731,0,1,86,4257731,4257731,0,1,86,0,0,0,0,0,ICMPV6,Network,0,6,,,,,
6611,6611,0,fe80::e8ff:97da:2f7f:abb3,08:00:27:38:31:62,08:00:27,0,ff02::1:ff62:aec8,33:33:ff:62:ae:c8,33:33:ff,0,58,6,0,0,4250731,4250731,0,1,86,4250731,4250731,0,1,86,0,0,0,0,0,ICMPV6,Network,0,6,,,,,
6612,6612,0,fe80::e1ff:dec7:bebd:f5d0,08:00:27:5e:a3:27,08:00:27,0,ff02::1:ff00:994,33:33:ff:00:09:94,33:33:ff,0,58,6,0,0,4254279,4254279,0,1,86,4254279,4254279,0,1,86,0,0,0,0,0,ICMPV6,Network,0,6,,,,,
6613,6613,0,fe80::5dd3:6bb3:7720:1e83,08:00:27:52:f4:11,08:00:27,0,ff02::1:ff00:2c6,33:33:ff:00:02:c6,33:33:ff,0,58,6,0,0,4255131,4255131,0,1,86,4255131,4255131,0,1,86,0,0,0,0,0,ICMPV6,Network,0,6,,,,,
6614,6614,0,fe80::5dd3:6bb3:7720:1e83,08:00:27:52:f4:11,08:00:27,0,ff02::1:ff2b:5398,33:33:ff:2b:53:98,33:33:ff,0,58,6,0,0,4254129,4254129,0,1,86,4254129,4254129,0,1,86,0,0,0,0,0,ICMPV6,Network,0,6,,,,,
6615,6615,0,fe80::f106:5909:32ae:f4cb,08:00:27:11:4e:fa,08:00:27,0,ff02::1:ffae:f4cb,33:33:ff:ae:f4:cb,33:33:ff,0,58,6,0,0,4258026,4258026,0,1,86,4258026,4258026,0,1,86,0,0,0,0,0,ICMPV6,Network,0,6,,,,,
6628,6628,0,fe80::e8ff:97da:2f7f:abb3,08:00:27:38:31:62,08:00:27,0,ff02::1:ff7f:abb3,33:33:ff:7f:ab:b3,33:33:ff,0,58,6,0,0,4258232,4377233,119001,2,172,4258232,4377233,119001,2,172,0,0,0,0,0,ICMPV6,Network,0,6,,,,,
6629,6629,0,fe80::f106:5909:32ae:f4cb,08:00:27:11:4e:fa,08:00:27,0,ff02::1:ffcc:1f02,33:33:ff:cc:1f:02,33:33:ff,0,58,6,0,0,4376026,4376026,0,1,86,4376026,4376026,0,1,86,0,0,0,0,0,ICMPV6,Network,0,6,,,,,
6630,6630,0,fe80::5dd3:6bb3:7720:1e83,08:00:27:52:f4:11,08:00:27,0,ff02::1:ff00:2c6,33:33:ff:00:02:c6,33:33:ff,0,58,6,0,0,4382634,4382634,0,1,86,4382634,4382634,0,1,86,0,0,0,0,0,ICMPV6,Network,0,6,,,,,
6631,6631,0,fe80::5dd3:6bb3:7720:1e83,08:00:27:52:f4:11,08:00:27,0,ff02::1:ff20:1e83,33:33:ff:20:1e:83,33:33:ff,0,58,6,0,0,4379630,4379630,0,1,86,4379630,4379630,0,1,86,0,0,0,0,0,ICMPV6,Network,0,6,,,,,
6632,6632,0,fe80::f106:5909:32ae:f4cb,08:00:27:11:4e:fa,08:00:27,0,ff02::1:ffae:f4cb,33:33:ff:ae:f4:cb,33:33:ff,0,58,6,0,0,4384527,4384527,0,1,86,4384527,4384527,0,1,86,0,0,0,0,0,ICMPV6,Network,0,6,,,,,
6633,6633,0,fe80::e1ff:dec7:bebd:f5d0,08:00:27:5e:a3:27,08:00:27,0,ff02::1:ffbd:f5d0,33:33:ff:bd:f5:d0,33:33:ff,0,58,6,0,0,4258776,4377277,118501,2,172,4258776,4377277,118501,2,172,0,0,0,0,0,ICMPV6,Network,0,6,,,,,
6634,6634,0,fe80::f106:5909:32ae:f4cb,08:00:27:11:4e:fa,08:00:27,0,ff02::1:ff00:4f7,33:33:ff:00:04:f7,33:33:ff,0,58,6,0,0,4376526,4376526,0,1,86,4376526,4376526,0,1,86,0,0,0,0,0,ICMPV6,Network,0,6,,,,,
6635,6635,0,fe80::e8ff:97da:2f7f:abb3,08:00:27:38:31:62,08:00:27,0,ff02::1:ff62:aec8,33:33:ff:62:ae:c8,33:33:ff,0,58,6,0,0,4381740,4381740,0,1,86,4381740,4381740,0,1,86,0,0,0,0,0,ICMPV6,Network,0,6,,,,,
6636,6636,0,fe80::e8ff:97da:2f7f:abb3,08:00:27:38:31:62,08:00:27,0,ff02::1:ff00:b30,33:33:ff:00:0b:30,33:33:ff,0,58,6,0,0,4381239,4381239,0,1,86,4381239,4381239,0,1,86,0,0,0,0,0,ICMPV6,Network,0,6,,,,,
6637,6637,0,fe80::5dd3:6bb3:7720:1e83,08:00:27:52:f4:11,08:00:27,0,ff02::1:ff2b:5398,33:33:ff:2b:53:98,33:33:ff,0,58,6,0,0,4384126,4384126,0,1,86,4384126,4384126,0,1,86,0,0,0,0,0,ICMPV6,Network,0,6,,,,,
6638,6638,0,fe80::e1ff:dec7:bebd:f5d0,08:00:27:5e:a3:27,08:00:27,0,ff02::1:ffb4:4877,33:33:ff:b4:48:77,33:33:ff,0,58,6,0,0,4379780,4379780,0,1,86,4379780,4379780,0,1,86,0,0,0,0,0,ICMPV6,Network,0,6,,,,,
6643,6643,0,::,08:00:27:5e:a3:27,08:00:27,0,ff02::1:ff00:b30,33:33:ff:00:0b:30,33:33:ff,0,58,6,0,0,4108284,4108284,0,1,78,4108284,4108284,0,1,78,0,0,0,0,0,ICMPV6,Network,0,6,,,,,
6644,6644,0,fd2d:ab8c:225::b30,08:00:27:38:31:62,08:00:27,0,ff02::1,33:33:00:00:00:01,33:33:00,0,58,6,0,0,4108284,4108284,0,1,86,4108284,4108284,0,1,86,0,0,0,0,0,ICMPV6,Network,0,6,,,,,
6645,6645,0,::,08:00:27:5e:a3:27,08:00:27,0,ff02::1:ff00:994,33:33:ff:00:09:94,33:33:ff,0,58,6,0,0,4133777,4133777,0,1,78,4133777,4133777,0,1,78,0,0,0,0,0,ICMPV6,Network,0,6,,,,,
6649,6649,0,192.168.1.168,f4:f5:d8:45:9f:1a,f4:f5:d8,5353,224.0.0.251,01:00:5e:00:00:fb,01:00:5e,5353,17,4,0,0,4288428,4368702,80274,2,768,4288428,4368702,80274,2,768,0,0,0,0,0,MDNS,Network,0,6,_googlecast._tcp.local,,,,
6659,6659,0,192.168.1.166,a4:5e:60:dd:58:1d,a4:5e:60,138,192.168.1.255,ff:ff:ff:ff:ff:ff,ff:ff:ff,138,17,4,0,0,4031424,4031431,7,2,432,4031424,4031431,7,2,432,0,0,0,0,0,NetBIOS.SMBv1,System,0,6,macbookpro-581d,,,,
6665,6665,0,fe80::da58:d7ff:fe00:f72,d8:58:d7:00:0f:72,d8:58:d7,0,ff02::1,33:33:00:00:00:01,33:33:00,0,58,6,0,0,4375351,4531022,155671,6,628,4375351,4531022,155671,6,628,0,0,0,0,0,ICMPV6,Network,0,6,,,,,
6666,6666,0,fe80::e1ff:dec7:bebd:f5d0,08:00:27:5e:a3:27,08:00:27,0,ff02::1:ffbd:f5d0,33:33:ff:bd:f5:d0,33:33:ff,0,58,6,0,0,4505781,4533281,27500,2,172,4505781,4533281,27500,2,172,0,0,0,0,0,ICMPV6,Network,0,6,,,,,
6667,6667,0,fe80::f106:5909:32ae:f4cb,08:00:27:11:4e:fa,08:00:27,0,ff02::1:ffae:f4cb,33:33:ff:ae:f4:cb,33:33:ff,0,58,6,0,0,4505532,4531028,25496,2,172,4505532,4531028,25496,2,172,0,0,0,0,0,ICMPV6,Network,0,6,,,,,
6668,6668,0,fe80::e8ff:97da:2f7f:abb3,08:00:27:38:31:62,08:00:27,0,ff02::1:ff00:b30,33:33:ff:00:0b:30,33:33:ff,0,58,6,0,0,4509233,4535731,26498,3,258,4509233,4535731,26498,3,258,0,0,0,0,0,ICMPV6,Network,0,6,,,,,
6669,6669,0,fe80::e1ff:dec7:bebd:f5d0,08:00:27:5e:a3:27,08:00:27,0,ff02::1:ff00:994,33:33:ff:00:09:94,33:33:ff,0,58,6,0,0,4382274,4531278,149004,4,344,4382274,4531278,149004,4,344,0,0,0,0,0,ICMPV6,Network,0,6,,,,,
6670,6670,0,fe80::f106:5909:32ae:f4cb,08:00:27:11:4e:fa,08:00:27,0,ff02::1:ffcc:1f02,33:33:ff:cc:1f:02,33:33:ff,0,58,6,0,0,4504029,4532030,28001,2,172,4504029,4532030,28001,2,172,0,0,0,0,0,ICMPV6,Network,0,6,,,,,
6671,6671,0,fe80::69b0:5ca7:a676:2c5a,08:00:27:0a:a9:9c,08:00:27,0,ff02::1:ff76:2c5a,33:33:ff:76:2c:5a,33:33:ff,0,58,6,0,0,4526446,4536451,10005,3,258,4526446,4536451,10005,3,258,0,0,0,0,0,ICMPV6,Network,0,6,,,,,
6672,6672,0,fe80::e8ff:97da:2f7f:abb3,08:00:27:38:31:62,08:00:27,0,ff02::1:ff7f:abb3,33:33:ff:7f:ab:b3,33:33:ff,0,58,6,0,0,4503735,4537734,33999,2,172,4503735,4537734,33999,2,172,0,0,0,0,0,ICMPV6,Network,0,6,,,,,
6673,6673,0,fe80::69b0:5ca7:a676:2c5a,08:00:27:0a:a9:9c,08:00:27,0,ff02::1:ffa6:7837,33:33:ff:a6:78:37,33:33:ff,0,58,6,0,0,4526447,4531454,5007,3,258,4526447,4531454,5007,3,258,0,0,0,0,0,ICMPV6,Network,0,6,,,,,
6675,6675,0,fe80::69b0:5ca7:a676:2c5a,08:00:27:0a:a9:9c,08:00:27,0,ff02::1:ff00:99e,33:33:ff:00:09:9e,33:33:ff,0,58,6,0,0,4540033,4540446,413,2,172,4540033,4540446,413,2,172,0,0,0,0,0,ICMPV6,Network,0,6,,,,,
6676,6676,0,fe80::5dd3:6bb3:7720:1e83,08:00:27:52:f4:11,08:00:27,0,ff02::1:ff20:1e83,33:33:ff:20:1e:83,33:33:ff,0,58,6,0,0,4504629,4534632,30003,2,172,4504629,4534632,30003,2,172,0,0,0,0,0,ICMPV6,Network,0,6,,,,,
6677,6677,0,fe80::5dd3:6bb3:7720:1e83,08:00:27:52:f4:11,08:00:27,0,ff02::1:ff00:2c6,33:33:ff:00:02:c6,33:33:ff,0,58,6,0,0,4504129,4539629,35500,2,172,4504129,4539629,35500,2,172,0,0,0,0,0,ICMPV6,Network,0,6,,,,,
6678,6678,0,fe80::e8ff:97da:2f7f:abb3,08:00:27:38:31:62,08:00:27,0,ff02::1:ff62:aec8,33:33:ff:62:ae:c8,33:33:ff,0,58,6,0,0,4508732,4540237,31505,2,172,4508732,4540237,31505,2,172,0,0,0,0,0,ICMPV6,Network,0,6,,,,,
6679,6679,0,fe80::5dd3:6bb3:7720:1e83,08:00:27:52:f4:11,08:00:27,0,ff02::1:ff2b:5398,33:33:ff:2b:53:98,33:33:ff,0,58,6,0,0,4509626,4538127,28501,2,172,4509626,4538127,28501,2,172,0,0,0,0,0,ICMPV6,Network,0,6,,,,,
6680,6680,0,fe80::e1ff:dec7:bebd:f5d0,08:00:27:5e:a3:27,08:00:27,0,ff02::1:ffb4:4877,33:33:ff:b4:48:77,33:33:ff,0,58,6,0,0,4510278,4536275,25997,2,172,4510278,4536275,25997,2,172,0,0,0,0,0,ICMPV6,Network,0,6,,,,,
6681,6681,0,fe80::f106:5909:32ae:f4cb,08:00:27:11:4e:fa,08:00:27,0,ff02::1:ff00:4f7,33:33:ff:00:04:f7,33:33:ff,0,58,6,0,0,4506022,4531529,25507,2,172,4506022,4531529,25507,2,172,0,0,0,0,0,ICMPV6,Network,0,6,,,,,
6701,6701,0,192.168.1.168,f4:f5:d8:45:9f:1a,f4:f5:d8,5353,224.0.0.251,01:00:5e:00:00:fb,01:00:5e,5353,17,4,0,0,4549339,4608732,59393,2,768,4549339,4608732,59393,2,768,0,0,0,0,0,MDNS,Network,0,6,_googlecast._tcp.local,,,,
6702,6702,0,fe80::da58:d7ff:fe00:f72,d8:58:d7:00:0f:72,d8:58:d7,0,ff02::1,33:33:00:00:00:01,33:33:00,0,58,6,0,0,4656437,4656437,0,1,86,4656437,4656437,0,1,86,0,0,0,0,0,ICMPV6,Network,0,6,,,,,
6703,6703,0,fe80::f106:5909:32ae:f4cb,08:00:27:11:4e:fa,08:00:27,0,ff02::1:ffcc:1f02,33:33:ff:cc:1f:02,33:33:ff,0,58,6,0,0,4658532,4658532,0,1,86,4658532,4658532,0,1,86,0,0,0,0,0,ICMPV6,Network,0,6,,,,,
6704,6704,0,fe80::f106:5909:32ae:f4cb,08:00:27:11:4e:fa,08:00:27,0,ff02::1:ffae:f4cb,33:33:ff:ae:f4:cb,33:33:ff,0,58,6,0,0,4657030,4657030,0,1,86,4657030,4657030,0,1,86,0,0,0,0,0,ICMPV6,Network,0,6,,,,,
6706,6706,0,fe80::69b0:5ca7:a676:2c5a,08:00:27:0a:a9:9c,08:00:27,0,ff02::1:ff76:2c5a,33:33:ff:76:2c:5a,33:33:ff,0,58,6,0,0,4659448,4659448,0,1,86,4659448,4659448,0,1,86,0,0,0,0,0,ICMPV6,Network,0,6,,,,,
6707,6707,0,fe80::e1ff:dec7:bebd:f5d0,08:00:27:5e:a3:27,08:00:27,0,ff02::1:ff00:994,33:33:ff:00:09:94,33:33:ff,0,58,6,0,0,4658281,4658281,0,1,86,4658281,4658281,0,1,86,0,0,0,0,0,ICMPV6,Network,0,6,,,,,
6708,6708,0,fe80::69b0:5ca7:a676:2c5a,08:00:27:0a:a9:9c,08:00:27,0,ff02::1:ffa6:7837,33:33:ff:a6:78:37,33:33:ff,0,58,6,0,0,4661450,4661450,0,1,86,4661450,4661450,0,1,86,0,0,0,0,0,ICMPV6,Network,0,6,,,,,
6709,6709,0,fe80::e1ff:dec7:bebd:f5d0,08:00:27:5e:a3:27,08:00:27,0,ff02::1:ffbd:f5d0,33:33:ff:bd:f5:d0,33:33:ff,0,58,6,0,0,4656779,4656779,0,1,86,4656779,4656779,0,1,86,0,0,0,0,0,ICMPV6,Network,0,6,,,,,
6710,6710,0,fe80::e8ff:97da:2f7f:abb3,08:00:27:38:31:62,08:00:27,0,ff02::1:ff00:b30,33:33:ff:00:0b:30,33:33:ff,0,58,6,0,0,4657235,4657235,0,1,86,4657235,4657235,0,1,86,0,0,0,0,0,ICMPV6,Network,0,6,,,,,
6711,6711,0,fe80::e8ff:97da:2f7f:abb3,08:00:27:38:31:62,08:00:27,0,ff02::1:ff7f:abb3,33:33:ff:7f:ab:b3,33:33:ff,0,58,6,0,0,4660731,4660731,0,1,86,4660731,4660731,0,1,86,0,0,0,0,0,ICMPV6,Network,0,6,,,,,
6712,6712,0,fe80::f106:5909:32ae:f4cb,08:00:27:11:4e:fa,08:00:27,0,ff02::1:ff00:4f7,33:33:ff:00:04:f7,33:33:ff,0,58,6,0,0,4665531,4665531,0,1,86,4665531,4665531,0,1,86,0,0,0,0,0,ICMPV6,Network,0,6,,,,,
6714,6714,0,fe80::5dd3:6bb3:7720:1e83,08:00:27:52:f4:11,08:00:27,0,ff02::1:ff2b:5398,33:33:ff:2b:53:98,33:33:ff,0,58,6,0,0,4665130,4665130,0,1,86,4665130,4665130,0,1,86,0,0,0,0,0,ICMPV6,Network,0,6,,,,,
6715,6715,0,fe80::69b0:5ca7:a676:2c5a,08:00:27:0a:a9:9c,08:00:27,0,ff02::1:ff00:99e,33:33:ff:00:09:9e,33:33:ff,0,58,6,0,0,4664445,4664445,0,1,86,4664445,4664445,0,1,86,0,0,0,0,0,ICMPV6,Network,0,6,,,,,
6716,6716,0,fe80::5dd3:6bb3:7720:1e83,08:00:27:52:f4:11,08:00:27,0,ff02::1:ff20:1e83,33:33:ff:20:1e:83,33:33:ff,0,58,6,0,0,4664630,4664630,0,1,86,4664630,4664630,0,1,86,0,0,0,0,0,ICMPV6,Network,0,6,,,,,
6717,6717,0,fe80::e1ff:dec7:bebd:f5d0,08:00:27:5e:a3:27,08:00:27,0,ff02::1:ffb4:4877,33:33:ff:b4:48:77,33:33:ff,0,58,6,0,0,4665280,4665280,0,1,86,4665280,4665280,0,1,86,0,0,0,0,0,ICMPV6,Network,0,6,,,,,
6718,6718,0,fd2d:ab8c:225:0:51e6:bfd4:61a6:7837,08:00:27:0a:a9:9c,08:00:27,0,ff02::1:ff00:1,33:33:ff:00:00:01,33:33:ff,0,58,6,0,0,4526860,4526860,0,1,86,4526860,4526860,0,1,86,0,0,0,0,0,ICMPV6,Network,0,6,,,,,
6719,6719,0,192.168.1.166,a4:5e:60:dd:58:1d,a4:5e:60,138,192.168.1.255,ff:ff:ff:ff:ff:ff,ff:ff:ff,138,17,4,0,0,4631565,4631565,0,3,648,4631565,4631565,0,3,648,0,0,0,0,0,NetBIOS.SMBv1,System,0,6,macbookpro-581d,,,,
6750,6750,0,fe80::69b0:5ca7:a676:2c5a,08:00:27:0a:a9:9c,08:00:27,0,ff02::1:ffa6:7837,33:33:ff:a6:78:37,33:33:ff,0,58,6,0,0,4784447,4784447,0,1,86,4784447,4784447,0,1,86,0,0,0,0,0,ICMPV6,Network,0,6,,,,,
6751,6751,0,fe80::f106:5909:32ae:f4cb,08:00:27:11:4e:fa,08:00:27,0,ff02::1:ff00:4f7,33:33:ff:00:04:f7,33:33:ff,0,58,6,0,0,4786526,4786526,0,1,86,4786526,4786526,0,1,86,0,0,0,0,0,ICMPV6,Network,0,6,,,,,
6752,6752,0,fe80::e8ff:97da:2f7f:abb3,08:00:27:38:31:62,08:00:27,0,ff02::1:ff7f:abb3,33:33:ff:7f:ab:b3,33:33:ff,0,58,6,0,0,4786231,4786231,0,1,86,4786231,4786231,0,1,86,0,0,0,0,0,ICMPV6,Network,0,6,,,,,
6753,6753,0,fe80::e1ff:dec7:bebd:f5d0,08:00:27:5e:a3:27,08:00:27,0,ff02::1:ffbd:f5d0,33:33:ff:bd:f5:d0,33:33:ff,0,58,6,0,0,4784773,4784773,0,1,86,4784773,4784773,0,1,86,0,0,0,0,0,ICMPV6,Network,0,6,,,,,
6754,6754,0,fe80::69b0:5ca7:a676:2c5a,08:00:27:0a:a9:9c,08:00:27,0,ff02::1:ff76:2c5a,33:33:ff:76:2c:5a,33:33:ff,0,58,6,0,0,4782945,4782945,0,1,86,4782945,4782945,0,1,86,0,0,0,0,0,ICMPV6,Network,0,6,,,,,
6757,6757,0,fe80::5dd3:6bb3:7720:1e83,08:00:27:52:f4:11,08:00:27,0,ff02::1:ff00:2c6,33:33:ff:00:02:c6,33:33:ff,0,58,6,0,0,4664630,4782129,117499,2,172,4664630,4782129,117499,2,172,0,0,0,0,0,ICMPV6,Network,0,6,,,,,
6758,6758,0,fe80::e1ff:dec7:bebd:f5d0,08:00:27:5e:a3:27,08:00:27,0,ff02::1:ffb4:4877,33:33:ff:b4:48:77,33:33:ff,0,58,6,0,0,4789779,4789779,0,1,86,4789779,4789779,0,1,86,0,0,0,0,0,ICMPV6,Network,0,6,,,,,
6759,6759,0,fe80::f106:5909:32ae:f4cb,08:00:27:11:4e:fa,08:00:27,0,ff02::1:ffae:f4cb,33:33:ff:ae:f4:cb,33:33:ff,0,58,6,0,0,4782530,4782530,0,1,86,4782530,4782530,0,1,86,0,0,0,0,0,ICMPV6,Network,0,6,,,,,
6760,6760,0,fe80::e1ff:dec7:bebd:f5d0,08:00:27:5e:a3:27,08:00:27,0,ff02::1:ff00:994,33:33:ff:00:09:94,33:33:ff,0,58,6,0,0,4783781,4783781,0,1,86,4783781,4783781,0,1,86,0,0,0,0,0,ICMPV6,Network,0,6,,,,,
6761,6761,0,fe80::5dd3:6bb3:7720:1e83,08:00:27:52:f4:11,08:00:27,0,ff02::1:ff20:1e83,33:33:ff:20:1e:83,33:33:ff,0,58,6,0,0,4788627,4788627,0,1,86,4788627,4788627,0,1,86,0,0,0,0,0,ICMPV6,Network,0,6,,,,,
6762,6762,0,fe80::e8ff:97da:2f7f:abb3,08:00:27:38:31:62,08:00:27,0,ff02::1:ff00:b30,33:33:ff:00:0b:30,33:33:ff,0,58,6,0,0,4785730,4785730,0,1,86,4785730,4785730,0,1,86,0,0,0,0,0,ICMPV6,Network,0,6,,,,,
6763,6763,0,fe80::69b0:5ca7:a676:2c5a,08:00:27:0a:a9:9c,08:00:27,0,ff02::1:ff00:99e,33:33:ff:00:09:9e,33:33:ff,0,58,6,0,0,4788453,4788453,0,1,86,4788453,4788453,0,1,86,0,0,0,0,0,ICMPV6,Network,0,6,,,,,
6764,6764,0,fe80::e8ff:97da:2f7f:abb3,08:00:27:38:31:62,08:00:27,0,ff02::1:ff62:aec8,33:33:ff:62:ae:c8,33:33:ff,0,58,6,0,0,4664736,4783737,119001,2,172,4664736,4783737,119001,2,172,0,0,0,0,0,ICMPV6,Network,0,6,,,,,
6765,6765,0,fe80::f106:5909:32ae:f4cb,08:00:27:11:4e:fa,08:00:27,0,ff02::1:ffcc:1f02,33:33:ff:cc:1f:02,33:33:ff,0,58,6,0,0,4782029,4782029,0,1,86,4782029,4782029,0,1,86,0,0,0,0,0,ICMPV6,Network,0,6,,,,,
6766,6766,0,fe80::5dd3:6bb3:7720:1e83,08:00:27:52:f4:11,08:00:27,0,ff02::1:ff2b:5398,33:33:ff:2b:53:98,33:33:ff,0,58,6,0,0,4788127,4788127,0,1,86,4788127,4788127,0,1,86,0,0,0,0,0,ICMPV6,Network,0,6,,,,,
6778,6778,0,192.168.1.168,f4:f5:d8:45:9f:1a,f4:f5:d8,5353,224.0.0.251,01:00:5e:00:00:fb,01:00:5e,5353,17,4,0,0,4767864,4828485,60621,2,768,4767864,4828485,60621,2,768,0,0,0,0,0,MDNS,Network,0,6,_googlecast._tcp.local,,,,
6779,6779,0,fe80::5dd3:6bb3:7720:1e83,08:00:27:52:f4:11,08:00:27,0,ff02::1:ff00:f72,33:33:ff:00:0f:72,33:33:ff,0,58,6,0,0,3712393,3942502,230109,4,344,3712393,3942502,230109,4,344,0,0,0,0,0,ICMPV6,Network,0,6,,,,,
6784,6784,0,fe80::da58:d7ff:fe00:f72,d8:58:d7:00:0f:72,d8:58:d7,0,ff02::1,33:33:00:00:00:01,33:33:00,0,58,6,0,0,4781876,4907315,125439,3,370,4781876,4907315,125439,3,370,0,0,0,0,0,ICMPV6,Network,0,6,,,,,
6785,6785,0,fe80::e8ff:97da:2f7f:abb3,08:00:27:38:31:62,08:00:27,0,ff02::1:ff00:b30,33:33:ff:00:0b:30,33:33:ff,0,58,6,0,0,4913234,4913234,0,1,86,4913234,4913234,0,1,86,0,0,0,0,0,ICMPV6,Network,0,6,,,,,
6786,6786,0,fe80::e1ff:dec7:bebd:f5d0,08:00:27:5e:a3:27,08:00:27,0,ff02::1:ffb4:4877,33:33:ff:b4:48:77,33:33:ff,0,58,6,0,0,4910774,4910774,0,1,86,4910774,4910774,0,1,86,0,0,0,0,0,ICMPV6,Network,0,6,,,,,
6787,6787,0,fe80::69b0:5ca7:a676:2c5a,08:00:27:0a:a9:9c,08:00:27,0,ff02::1:ff76:2c5a,33:33:ff:76:2c:5a,33:33:ff,0,58,6,0,0,4909447,4909447,0,1,86,4909447,4909447,0,1,86,0,0,0,0,0,ICMPV6,Network,0,6,,,,,
6788,6788,0,fe80::f106:5909:32ae:f4cb,08:00:27:11:4e:fa,08:00:27,0,ff02::1:ffae:f4cb,33:33:ff:ae:f4:cb,33:33:ff,0,58,6,0,0,4912026,4912026,0,1,86,4912026,4912026,0,1,86,0,0,0,0,0,ICMPV6,Network,0,6,,,,,
6790,6790,0,fe80::e8ff:97da:2f7f:abb3,08:00:27:38:31:62,08:00:27,0,ff02::1:ff7f:abb3,33:33:ff:7f:ab:b3,33:33:ff,0,58,6,0,0,4907736,4907736,0,1,86,4907736,4907736,0,1,86,0,0,0,0,0,ICMPV6,Network,0,6,,,,,
6791,6791,0,fe80::e1ff:dec7:bebd:f5d0,08:00:27:5e:a3:27,08:00:27,0,ff02::1:ff00:994,33:33:ff:00:09:94,33:33:ff,0,58,6,0,0,4912776,4912776,0,1,86,4912776,4912776,0,1,86,0,0,0,0,0,ICMPV6,Network,0,6,,,,,
6792,6792,0,fe80::69b0:5ca7:a676:2c5a,08:00:27:0a:a9:9c,08:00:27,0,ff02::1:ffa6:7837,33:33:ff:a6:78:37,33:33:ff,0,58,6,0,0,4907444,4907444,0,1,86,4907444,4907444,0,1,86,0,0,0,0,0,ICMPV6,Network,0,6,,,,,
6794,6794,0,fe80::5dd3:6bb3:7720:1e83,08:00:27:52:f4:11,08:00:27,0,ff02::1:ff20:1e83,33:33:ff:20:1e:83,33:33:ff,0,58,6,0,0,4913127,4913127,0,1,86,4913127,4913127,0,1,86,0,0,0,0,0,ICMPV6,Network,0,6,,,,,
6795,6795,0,fe80::5dd3:6bb3:7720:1e83,08:00:27:52:f4:11,08:00:27,0,ff02::1:ff00:2c6,33:33:ff:00:02:c6,33:33:ff,0,58,6,0,0,4910633,4910633,0,1,86,4910633,4910633,0,1,86,0,0,0,0,0,ICMPV6,Network,0,6,,,,,
6796,6796,0,fe80::e8ff:97da:2f7f:abb3,08:00:27:38:31:62,08:00:27,0,ff02::1:ff62:aec8,33:33:ff:62:ae:c8,33:33:ff,0,58,6,0,0,4914736,4914736,0,1,86,4914736,4914736,0,1,86,0,0,0,0,0,ICMPV6,Network,0,6,,,,,
6797,6797,0,fe80::e1ff:dec7:bebd:f5d0,08:00:27:5e:a3:27,08:00:27,0,ff02::1:ffbd:f5d0,33:33:ff:bd:f5:d0,33:33:ff,0,58,6,0,0,4908781,4908781,0,1,86,4908781,4908781,0,1,86,0,0,0,0,0,ICMPV6,Network,0,6,,,,,
6798,6798,0,fe80::f106:5909:32ae:f4cb,08:00:27:11:4e:fa,08:00:27,0,ff02::1:ff00:4f7,33:33:ff:00:04:f7,33:33:ff,0,58,6,0,0,4907530,4907530,0,1,86,4907530,4907530,0,1,86,0,0,0,0,0,ICMPV6,Network,0,6,,,,,
6813,6813,0,fe80::da58:d7ff:fe00:f72,d8:58:d7:00:0f:72,d8:58:d7,0,ff02::1,33:33:00:00:00:01,33:33:00,0,58,6,0,0,5032754,5032754,0,1,86,5032754,5032754,0,1,86,0,0,0,0,0,ICMPV6,Network,0,6,,,,,
6814,6814,0,fe80::e8ff:97da:2f7f:abb3,08:00:27:38:31:62,08:00:27,0,ff02::1:ff62:aec8,33:33:ff:62:ae:c8,33:33:ff,0,58,6,0,0,5039736,5039736,0,1,86,5039736,5039736,0,1,86,0,0,0,0,0,ICMPV6,Network,0,6,,,,,
6815,6815,0,fe80::69b0:5ca7:a676:2c5a,08:00:27:0a:a9:9c,08:00:27,0,ff02::1:ffa6:7837,33:33:ff:a6:78:37,33:33:ff,0,58,6,0,0,5037451,5037451,0,1,86,5037451,5037451,0,1,86,0,0,0,0,0,ICMPV6,Network,0,6,,,,,
6816,6816,0,fe80::5dd3:6bb3:7720:1e83,08:00:27:52:f4:11,08:00:27,0,ff02::1:ff2b:5398,33:33:ff:2b:53:98,33:33:ff,0,58,6,0,0,4916632,5033629,116997,2,172,4916632,5033629,116997,2,172,0,0,0,0,0,ICMPV6,Network,0,6,,,,,
6817,6817,0,fe80::f106:5909:32ae:f4cb,08:00:27:11:4e:fa,08:00:27,0,ff02::1:ffae:f4cb,33:33:ff:ae:f4:cb,33:33:ff,0,58,6,0,0,5035023,5035023,0,1,86,5035023,5035023,0,1,86,0,0,0,0,0,ICMPV6,Network,0,6,,,,,
6818,6818,0,fe80::e1ff:dec7:bebd:f5d0,08:00:27:5e:a3:27,08:00:27,0,ff02::1:ffb4:4877,33:33:ff:b4:48:77,33:33:ff,0,58,6,0,0,5033280,5033280,0,1,86,5033280,5033280,0,1,86,0,0,0,0,0,ICMPV6,Network,0,6,,,,,
6819,6819,0,fe80::e1ff:dec7:bebd:f5d0,08:00:27:5e:a3:27,08:00:27,0,ff02::1:ffbd:f5d0,33:33:ff:bd:f5:d0,33:33:ff,0,58,6,0,0,5039779,5039779,0,1,86,5039779,5039779,0,1,86,0,0,0,0,0,ICMPV6,Network,0,6,,,,,
6820,6820,0,fe80::69b0:5ca7:a676:2c5a,08:00:27:0a:a9:9c,08:00:27,0,ff02::1:ff76:2c5a,33:33:ff:76:2c:5a,33:33:ff,0,58,6,0,0,5034447,5034447,0,1,86,5034447,5034447,0,1,86,0,0,0,0,0,ICMPV6,Network,0,6,,,,,
6821,6821,0,fe80::e8ff:97da:2f7f:abb3,08:00:27:38:31:62,08:00:27,0,ff02::1:ff00:b30,33:33:ff:00:0b:30,33:33:ff,0,58,6,0,0,5033236,5033236,0,1,86,5033236,5033236,0,1,86,0,0,0,0,0,ICMPV6,Network,0,6,,,,,
6822,6822,0,fe80::e1ff:dec7:bebd:f5d0,08:00:27:5e:a3:27,08:00:27,0,ff02::1:ff00:994,33:33:ff:00:09:94,33:33:ff,0,58,6,0,0,5037275,5037275,0,1,86,5037275,5037275,0,1,86,0,0,0,0,0,ICMPV6,Network,0,6,,,,,
6823,6823,0,fe80::69b0:5ca7:a676:2c5a,08:00:27:0a:a9:9c,08:00:27,0,ff02::1:ff00:99e,33:33:ff:00:09:9e,33:33:ff,0,58,6,0,0,4913452,5032944,119492,2,172,4913452,5032944,119492,2,172,0,0,0,0,0,ICMPV6,Network,0,6,,,,,
6824,6824,0,fe80::e8ff:97da:2f7f:abb3,08:00:27:38:31:62,08:00:27,0,ff02::1:ff7f:abb3,33:33:ff:7f:ab:b3,33:33:ff,0,58,6,0,0,5035239,5035239,0,1,86,5035239,5035239,0,1,86,0,0,0,0,0,ICMPV6,Network,0,6,,,,,
6825,6825,0,fe80::f106:5909:32ae:f4cb,08:00:27:11:4e:fa,08:00:27,0,ff02::1:ffcc:1f02,33:33:ff:cc:1f:02,33:33:ff,0,58,6,0,0,4915031,5034523,119492,2,172,4915031,5034523,119492,2,172,0,0,0,0,0,ICMPV6,Network,0,6,,,,,
6826,6826,0,fe80::5dd3:6bb3:7720:1e83,08:00:27:52:f4:11,08:00:27,0,ff02::1:ff20:1e83,33:33:ff:20:1e:83,33:33:ff,0,58,6,0,0,5038627,5038627,0,1,86,5038627,5038627,0,1,86,0,0,0,0,0,ICMPV6,Network,0,6,,,,,
6838,6838,0,192.168.1.168,f4:f5:d8:45:9f:1a,f4:f5:d8,5353,224.0.0.251,01:00:5e:00:00:fb,01:00:5e,5353,17,4,0,0,5008098,5068517,60419,2,768,5008098,5068517,60419,2,768,0,0,0,0,0,MDNS,Network,0,6,_googlecast._tcp.local,,,,
6840,6840,0,::,08:00:27:0a:a9:9c,08:00:27,0,ff02::1:ff00:99e,33:33:ff:00:09:9e,33:33:ff,0,58,6,0,0,4540446,4540446,0,1,78,4540446,4540446,0,1,78,0,0,0,0,0,ICMPV6,Network,0,6,,,,,
6856,6856,0,192.168.1.133,d8:bb:2c:43:01:45,d8:bb:2c,5353,224.0.0.251,01:00:5e:00:00:fb,01:00:5e,5353,17,4,0,0,5002553,5138479,135926,10,1120,5002553,5138479,135926,10,1120,0,0,0,0,0,MDNS,Network,0,6,_sleep-proxy._udp.local,,,,
6863,6863,0,fe80::5dd3:6bb3:7720:1e83,08:00:27:52:f4:11,08:00:27,0,ff02::1:ff2b:5398,33:33:ff:2b:53:98,33:33:ff,0,58,6,0,0,5160632,5269142,108510,2,172,5160632,5269142,108510,2,172,0,0,0,0,0,ICMPV6,Network,0,6,,,,,
6864,6864,0,fe80::e8ff:97da:2f7f:abb3,08:00:27:38:31:62,08:00:27,0,ff02::1:ff62:aec8,33:33:ff:62:ae:c8,33:33:ff,0,58,6,0,0,5159738,5272731,112993,2,172,5159738,5272731,112993,2,172,0,0,0,0,0,ICMPV6,Network,0,6,,,,,
6865,6865,0,fe80::f106:5909:32ae:f4cb,08:00:27:11:4e:fa,08:00:27,0,ff02::1:ffae:f4cb,33:33:ff:ae:f4:cb,33:33:ff,0,58,6,0,0,5161024,5269029,108005,2,172,5161024,5269029,108005,2,172,0,0,0,0,0,ICMPV6,Network,0,6,,,,,
6866,6866,0,fe80::e1ff:dec7:bebd:f5d0,08:00:27:5e:a3:27,08:00:27,0,ff02::1:ff00:994,33:33:ff:00:09:94,33:33:ff,0,58,6,0,0,5164278,5269279,105001,2,172,5164278,5269279,105001,2,172,0,0,0,0,0,ICMPV6,Network,0,6,,,,,
6867,6867,0,fe80::69b0:5ca7:a676:2c5a,08:00:27:0a:a9:9c,08:00:27,0,ff02::1:ffa6:7837,33:33:ff:a6:78:37,33:33:ff,0,58,6,0,0,5160448,5274952,114504,2,172,5160448,5274952,114504,2,172,0,0,0,0,0,ICMPV6,Network,0,6,,,,,
6868,6868,0,fe80::5dd3:6bb3:7720:1e83,08:00:27:52:f4:11,08:00:27,0,ff02::1:ff20:1e83,33:33:ff:20:1e:83,33:33:ff,0,58,6,0,0,5167632,5270641,103009,2,172,5167632,5270641,103009,2,172,0,0,0,0,0,ICMPV6,Network,0,6,,,,,
6869,6869,0,fe80::69b0:5ca7:a676:2c5a,08:00:27:0a:a9:9c,08:00:27,0,ff02::1:ff76:2c5a,33:33:ff:76:2c:5a,33:33:ff,0,58,6,0,0,5163452,5274952,111500,2,172,5163452,5274952,111500,2,172,0,0,0,0,0,ICMPV6,Network,0,6,,,,,
6870,6870,0,fe80::f106:5909:32ae:f4cb,08:00:27:11:4e:fa,08:00:27,0,ff02::1:ff00:4f7,33:33:ff:00:04:f7,33:33:ff,0,58,6,0,0,5041522,5274527,233005,3,258,5041522,5274527,233005,3,258,0,0,0,0,0,ICMPV6,Network,0,6,,,,,
6871,6871,0,fe80::b504:f453:742b:7a21,08:00:27:c3:f9:98,08:00:27,0,ff02::1:ffba:1f64,33:33:ff:ba:1f:64,33:33:ff,0,58,6,0,0,5264399,5276907,12508,3,258,5264399,5276907,12508,3,258,0,0,0,0,0,ICMPV6,Network,0,6,,,,,
6872,6872,0,fe80::69b0:5ca7:a676:2c5a,08:00:27:0a:a9:9c,08:00:27,0,ff02::1:ff00:99e,33:33:ff:00:09:9e,33:33:ff,0,58,6,0,0,5165946,5274952,109006,4,344,5165946,5274952,109006,4,344,0,0,0,0,0,ICMPV6,Network,0,6,,,,,
6873,6873,0,fe80::e8ff:97da:2f7f:abb3,08:00:27:38:31:62,08:00:27,0,ff02::1:ff7f:abb3,33:33:ff:7f:ab:b3,33:33:ff,0,58,6,0,0,5166237,5274233,107996,2,172,5166237,5274233,107996,2,172,0,0,0,0,0,ICMPV6,Network,0,6,,,,,
6874,6874,0,fe80::e8ff:97da:2f7f:abb3,08:00:27:38:31:62,08:00:27,0,ff02::1:ff00:b30,33:33:ff:00:0b:30,33:33:ff,0,58,6,0,0,5163734,5272731,108997,2,172,5163734,5272731,108997,2,172,0,0,0,0,0,ICMPV6,Network,0,6,,,,,
6875,6875,0,fe80::e1ff:dec7:bebd:f5d0,08:00:27:5e:a3:27,08:00:27,0,ff02::1:ffb4:4877,33:33:ff:b4:48:77,33:33:ff,0,58,6,0,0,5161274,5272273,110999,2,172,5161274,5272273,110999,2,172,0,0,0,0,0,ICMPV6,Network,0,6,,,,,
6877,6877,0,fe80::b504:f453:742b:7a21,08:00:27:c3:f9:98,08:00:27,0,ff02::1:ff2b:7a21,33:33:ff:2b:7a:21,33:33:ff,0,58,6,0,0,5264399,5276406,12007,3,258,5264399,5276406,12007,3,258,0,0,0,0,0,ICMPV6,Network,0,6,,,,,
6878,6878,0,fe80::5dd3:6bb3:7720:1e83,08:00:27:52:f4:11,08:00:27,0,ff02::1:ff00:2c6,33:33:ff:00:02:c6,33:33:ff,0,58,6,0,0,5039127,5270641,231514,3,258,5039127,5270641,231514,3,258,0,0,0,0,0,ICMPV6,Network,0,6,,,,,
6879,6879,0,fe80::e1ff:dec7:bebd:f5d0,08:00:27:5e:a3:27,08:00:27,0,ff02::1:ffbd:f5d0,33:33:ff:bd:f5:d0,33:33:ff,0,58,6,0,0,5161775,5270781,109006,2,172,5161775,5270781,109006,2,172,0,0,0,0,0,ICMPV6,Network,0,6,,,,,
6880,6880,0,fe80::f106:5909:32ae:f4cb,08:00:27:11:4e:fa,08:00:27,0,ff02::1:ffcc:1f02,33:33:ff:cc:1f:02,33:33:ff,0,58,6,0,0,5167523,5274027,106504,2,172,5167523,5274027,106504,2,172,0,0,0,0,0,ICMPV6,Network,0,6,,,,,
6885,6885,0,192.168.1.166,a4:5e:60:dd:58:1d,a4:5e:60,138,192.168.1.255,ff:ff:ff:ff:ff:ff,ff:ff:ff,138,17,4,0,0,4791420,4792031,611,4,864,4791420,4792031,611,4,864,0,0,0,0,0,NetBIOS.SMBv1,System,0,6,macbookpro-581d,,,,
6943,6943,0,fe80::f106:5909:32ae:f4cb,08:00:27:11:4e:fa,08:00:27,546,ff02::1:2,33:33:00:01:00:02,33:33:00,547,17,6,0,0,3664065,3677752,13687,6,1004,3664065,3677752,13687,6,1004,0,0,0,0,0,DHCPV6,Network,0,6,,,,,
6944,6944,0,fe80::f106:5909:32ae:f4cb,08:00:27:11:4e:fa,08:00:27,0,ff02::2,33:33:00:00:00:02,33:33:00,0,58,6,0,0,3664078,3666736,2658,2,172,3664078,3666736,2658,2,172,0,0,0,0,0,ICMPV6,Network,0,6,,,,,
6950,6950,0,fe80::f106:5909:32ae:f4cb,08:00:27:11:4e:fa,08:00:27,0,ff02::1:ff00:b30,33:33:ff:00:0b:30,33:33:ff,0,58,6,0,0,3666239,3666506,267,2,172,3666239,3666506,267,2,172,0,0,0,0,0,ICMPV6,Network,0,6,,,,,
7210,7210,0,192.168.1.168,f4:f5:d8:45:9f:1a,f4:f5:d8,5353,224.0.0.251,01:00:5e:00:00:fb,01:00:5e,5353,17,4,0,0,5247104,5308544,61440,2,768,5247104,5308544,61440,2,768,0,0,0,0,0,MDNS,Network,0,6,_googlecast._tcp.local,,,,
7217,7217,0,fe80::da58:d7ff:fe00:f72,d8:58:d7:00:0f:72,d8:58:d7,0,ff02::1,33:33:00:00:00:01,33:33:00,0,58,6,0,0,5158194,5394224,236030,6,628,5158194,5394224,236030,6,628,0,0,0,0,0,ICMPV6,Network,0,6,,,,,
7219,7219,0,fe80::69b0:5ca7:a676:2c5a,08:00:27:0a:a9:9c,08:00:27,0,ff02::1:ffa6:7837,33:33:ff:a6:78:37,33:33:ff,0,58,6,0,0,5396948,5396948,0,1,86,5396948,5396948,0,1,86,0,0,0,0,0,ICMPV6,Network,0,6,,,,,
7220,7220,0,fe80::5dd3:6bb3:7720:1e83,08:00:27:52:f4:11,08:00:27,0,ff02::1:ff2b:5398,33:33:ff:2b:53:98,33:33:ff,0,58,6,0,0,5394639,5394639,0,1,86,5394639,5394639,0,1,86,0,0,0,0,0,ICMPV6,Network,0,6,,,,,
7221,7221,0,fe80::f106:5909:32ae:f4cb,08:00:27:11:4e:fa,08:00:27,0,ff02::1:ffae:f4cb,33:33:ff:ae:f4:cb,33:33:ff,0,58,6,0,0,5395531,5395531,0,1,86,5395531,5395531,0,1,86,0,0,0,0,0,ICMPV6,Network,0,6,,,,,
7222,7222,0,fe80::f106:5909:32ae:f4cb,08:00:27:11:4e:fa,08:00:27,0,ff02::1:ff00:4f7,33:33:ff:00:04:f7,33:33:ff,0,58,6,0,0,5399527,5399527,0,1,86,5399527,5399527,0,1,86,0,0,0,0,0,ICMPV6,Network,0,6,,,,,
7223,7223,0,fe80::5dd3:6bb3:7720:1e83,08:00:27:52:f4:11,08:00:27,0,ff02::1:ff20:1e83,33:33:ff:20:1e:83,33:33:ff,0,58,6,0,0,5397143,5397143,0,1,86,5397143,5397143,0,1,86,0,0,0,0,0,ICMPV6,Network,0,6,,,,,
7224,7224,0,fe80::e8ff:97da:2f7f:abb3,08:00:27:38:31:62,08:00:27,0,ff02::1:ff7f:abb3,33:33:ff:7f:ab:b3,33:33:ff,0,58,6,0,0,5400734,5400734,0,1,86,5400734,5400734,0,1,86,0,0,0,0,0,ICMPV6,Network,0,6,,,,,
7225,7225,0,fe80::69b0:5ca7:a676:2c5a,08:00:27:0a:a9:9c,08:00:27,0,ff02::1:ff76:2c5a,33:33:ff:76:2c:5a,33:33:ff,0,58,6,0,0,5399451,5399451,0,1,86,5399451,5399451,0,1,86,0,0,0,0,0,ICMPV6,Network,0,6,,,,,
7226,7226,0,fe80::e8ff:97da:2f7f:abb3,08:00:27:38:31:62,08:00:27,0,ff02::1:ff00:b30,33:33:ff:00:0b:30,33:33:ff,0,58,6,0,0,5400734,5400734,0,1,86,5400734,5400734,0,1,86,0,0,0,0,0,ICMPV6,Network,0,6,,,,,
7227,7227,0,fe80::e1ff:dec7:bebd:f5d0,08:00:27:5e:a3:27,08:00:27,0,ff02::1:ffbd:f5d0,33:33:ff:bd:f5:d0,33:33:ff,0,58,6,0,0,5402781,5402781,0,1,86,5402781,5402781,0,1,86,0,0,0,0,0,ICMPV6,Network,0,6,,,,,
7228,7228,0,fe80::e1ff:dec7:bebd:f5d0,08:00:27:5e:a3:27,08:00:27,0,ff02::1:ffb4:4877,33:33:ff:b4:48:77,33:33:ff,0,58,6,0,0,5400778,5400778,0,1,86,5400778,5400778,0,1,86,0,0,0,0,0,ICMPV6,Network,0,6,,,,,
7229,7229,0,fe80::b504:f453:742b:7a21,08:00:27:c3:f9:98,08:00:27,0,ff02::1:ff2b:7a21,33:33:ff:2b:7a:21,33:33:ff,0,58,6,0,0,5400905,5400905,0,1,86,5400905,5400905,0,1,86,0,0,0,0,0,ICMPV6,Network,0,6,,,,,
7230,7230,0,fe80::69b0:5ca7:a676:2c5a,08:00:27:0a:a9:9c,08:00:27,0,ff02::1:ff00:99e,33:33:ff:00:09:9e,33:33:ff,0,58,6,0,0,5399953,5399953,0,1,86,5399953,5399953,0,1,86,0,0,0,0,0,ICMPV6,Network,0,6,,,,,
7231,7231,0,fe80::b504:f453:742b:7a21,08:00:27:c3:f9:98,08:00:27,0,ff02::1:ffba:1f64,33:33:ff:ba:1f:64,33:33:ff,0,58,6,0,0,5399904,5399904,0,1,86,5399904,5399904,0,1,86,0,0,0,0,0,ICMPV6,Network,0,6,,,,,
7232,7232,0,fe80::e8ff:97da:2f7f:abb3,08:00:27:38:31:62,08:00:27,0,ff02::1:ff62:aec8,33:33:ff:62:ae:c8,33:33:ff,0,58,6,0,0,5395236,5395236,0,1,86,5395236,5395236,0,1,86,0,0,0,0,0,ICMPV6,Network,0,6,,,,,
7233,7233,0,fe80::e1ff:dec7:bebd:f5d0,08:00:27:5e:a3:27,08:00:27,0,ff02::1:ff00:994,33:33:ff:00:09:94,33:33:ff,0,58,6,0,0,5396773,5396773,0,1,86,5396773,5396773,0,1,86,0,0,0,0,0,ICMPV6,Network,0,6,,,,,
7234,7234,0,fe80::b504:f453:742b:7a21,08:00:27:c3:f9:98,08:00:27,0,ff02::1:ff00:fa9,33:33:ff:00:0f:a9,33:33:ff,0,58,6,0,0,5277965,5395908,117943,3,258,5277965,5395908,117943,3,258,0,0,0,0,0,ICMPV6,Network,0,6,,,,,
7275,7275,0,fe80::da58:d7ff:fe00:f72,d8:58:d7:00:0f:72,d8:58:d7,0,ff02::1,33:33:00:00:00:01,33:33:00,0,58,6,0,0,5519664,5519664,0,1,86,5519664,5519664,0,1,86,0,0,0,0,0,ICMPV6,Network,0,6,,,,,
7276,7276,0,fe80::b504:f453:742b:7a21,08:00:27:c3:f9:98,08:00:27,0,ff02::1:ff2b:7a21,33:33:ff:2b:7a:21,33:33:ff,0,58,6,0,0,5525404,5525404,0,1,86,5525404,5525404,0,1,86,0,0,0,0,0,ICMPV6,Network,0,6,,,,,
7277,7277,0,fe80::f106:5909:32ae:f4cb,08:00:27:11:4e:fa,08:00:27,0,ff02::1:ffcc:1f02,33:33:ff:cc:1f:02,33:33:ff,0,58,6,0,0,5403022,5520031,117009,2,172,5403022,5520031,117009,2,172,0,0,0,0,0,ICMPV6,Network,0,6,,,,,
7278,7278,0,fe80::f106:5909:32ae:f4cb,08:00:27:11:4e:fa,08:00:27,0,ff02::1:ff00:4f7,33:33:ff:00:04:f7,33:33:ff,0,58,6,0,0,5521523,5521523,0,1,86,5521523,5521523,0,1,86,0,0,0,0,0,ICMPV6,Network,0,6,,,,,
7279,7279,0,fe80::5dd3:6bb3:7720:1e83,08:00:27:52:f4:11,08:00:27,0,ff02::1:ff20:1e83,33:33:ff:20:1e:83,33:33:ff,0,58,6,0,0,5522142,5522142,0,1,86,5522142,5522142,0,1,86,0,0,0,0,0,ICMPV6,Network,0,6,,,,,
7281,7281,0,fe80::e8ff:97da:2f7f:abb3,08:00:27:38:31:62,08:00:27,0,ff02::1:ff00:b30,33:33:ff:00:0b:30,33:33:ff,0,58,6,0,0,5525233,5525233,0,1,86,5525233,5525233,0,1,86,0,0,0,0,0,ICMPV6,Network,0,6,,,,,
7282,7282,0,fe80::69b0:5ca7:a676:2c5a,08:00:27:0a:a9:9c,08:00:27,0,ff02::1:ff00:99e,33:33:ff:00:09:9e,33:33:ff,0,58,6,0,0,5526945,5526945,0,1,86,5526945,5526945,0,1,86,0,0,0,0,0,ICMPV6,Network,0,6,,,,,
7283,7283,0,fe80::e1ff:dec7:bebd:f5d0,08:00:27:5e:a3:27,08:00:27,0,ff02::1:ff00:994,33:33:ff:00:09:94,33:33:ff,0,58,6,0,0,5527781,5527781,0,1,86,5527781,5527781,0,1,86,0,0,0,0,0,ICMPV6,Network,0,6,,,,,
7284,7284,0,fe80::e1ff:dec7:bebd:f5d0,08:00:27:5e:a3:27,08:00:27,0,ff02::1:ffb4:4877,33:33:ff:b4:48:77,33:33:ff,0,58,6,0,0,5525277,5525277,0,1,86,5525277,5525277,0,1,86,0,0,0,0,0,ICMPV6,Network,0,6,,,,,
7285,7285,0,fe80::f106:5909:32ae:f4cb,08:00:27:11:4e:fa,08:00:27,0,ff02::1:ffae:f4cb,33:33:ff:ae:f4:cb,33:33:ff,0,58,6,0,0,5521031,5521031,0,1,86,5521031,5521031,0,1,86,0,0,0,0,0,ICMPV6,Network,0,6,,,,,
7286,7286,0,fe80::5dd3:6bb3:7720:1e83,08:00:27:52:f4:11,08:00:27,0,ff02::1:ff2b:5398,33:33:ff:2b:53:98,33:33:ff,0,58,6,0,0,5520140,5520140,0,1,86,5520140,5520140,0,1,86,0,0,0,0,0,ICMPV6,Network,0,6,,,,,
7287,7287,0,fe80::5dd3:6bb3:7720:1e83,08:00:27:52:f4:11,08:00:27,0,ff02::1:ff00:2c6,33:33:ff:00:02:c6,33:33:ff,0,58,6,0,0,5401639,5521141,119502,2,172,5401639,5521141,119502,2,172,0,0,0,0,0,ICMPV6,Network,0,6,,,,,
7288,7288,0,fe80::e8ff:97da:2f7f:abb3,08:00:27:38:31:62,08:00:27,0,ff02::1:ff7f:abb3,33:33:ff:7f:ab:b3,33:33:ff,0,58,6,0,0,5523731,5523731,0,1,86,5523731,5523731,0,1,86,0,0,0,0,0,ICMPV6,Network,0,6,,,,,
7289,7289,0,fe80::69b0:5ca7:a676:2c5a,08:00:27:0a:a9:9c,08:00:27,0,ff02::1:ff76:2c5a,33:33:ff:76:2c:5a,33:33:ff,0,58,6,0,0,5523951,5523951,0,1,86,5523951,5523951,0,1,86,0,0,0,0,0,ICMPV6,Network,0,6,,,,,
7290,7290,0,fe80::b504:f453:742b:7a21,08:00:27:c3:f9:98,08:00:27,0,ff02::1:ffba:1f64,33:33:ff:ba:1f:64,33:33:ff,0,58,6,0,0,5527406,5527406,0,1,86,5527406,5527406,0,1,86,0,0,0,0,0,ICMPV6,Network,0,6,,,,,
7291,7291,0,fe80::69b0:5ca7:a676:2c5a,08:00:27:0a:a9:9c,08:00:27,0,ff02::1:ffa6:7837,33:33:ff:a6:78:37,33:33:ff,0,58,6,0,0,5519945,5519945,0,1,86,5519945,5519945,0,1,86,0,0,0,0,0,ICMPV6,Network,0,6,,,,,
7292,7292,0,fe80::e1ff:dec7:bebd:f5d0,08:00:27:5e:a3:27,08:00:27,0,ff02::1:ffbd:f5d0,33:33:ff:bd:f5:d0,33:33:ff,0,58,6,0,0,5525277,5525277,0,1,86,5525277,5525277,0,1,86,0,0,0,0,0,ICMPV6,Network,0,6,,,,,
7743,7743,0,::,08:00:27:5e:a3:27,08:00:27,0,ff02::1:ffbd:f5d0,33:33:ff:bd:f5:d0,33:33:ff,0,58,6,0,0,4108283,4108283,0,2,156,4108283,4108283,0,2,156,0,0,0,0,0,ICMPV6,Network,0,6,,,,,
7744,7744,0,::,08:00:27:5e:a3:27,08:00:27,0,ff02::1:ffb4:4877,33:33:ff:b4:48:77,33:33:ff,0,58,6,0,0,4108283,4108283,0,1,78,4108283,4108283,0,1,78,0,0,0,0,0,ICMPV6,Network,0,6,,,,,
7745,7745,0,fe80::e1ff:dec7:bebd:f5d0,08:00:27:5e:a3:27,08:00:27,0,ff02::2,33:33:00:00:00:02,33:33:00,0,58,6,0,0,4108284,4122501,14217,6,468,4108284,4122501,14217,6,468,0,0,0,0,0,ICMPV6,Network,0,6,,,,,
7746,7746,0,fe80::e1ff:dec7:bebd:f5d0,08:00:27:5e:a3:27,08:00:27,0,ff02::1:ff00:b30,33:33:ff:00:0b:30,33:33:ff,0,58,6,0,0,4108284,4108781,497,2,172,4108284,4108781,497,2,172,0,0,0,0,0,ICMPV6,Network,0,6,,,,,
7752,7752,0,fe80::e1ff:dec7:bebd:f5d0,08:00:27:5e:a3:27,08:00:27,0,ff02::1:ff00:4f7,33:33:ff:00:04:f7,33:33:ff,0,58,6,0,0,4110497,4110774,277,2,172,4110497,4110774,277,2,172,0,0,0,0,0,ICMPV6,Network,0,6,,,,,
7753,7753,0,::,08:00:27:5e:a3:27,08:00:27,0,ff02::1:ff00:4f7,33:33:ff:00:04:f7,33:33:ff,0,58,6,0,0,4110774,4110774,0,1,78,4110774,4110774,0,1,78,0,0,0,0,0,ICMPV6,Network,0,6,,,,,
7754,7754,0,fd2d:ab8c:225::4f7,08:00:27:11:4e:fa,08:00:27,0,ff02::1,33:33:00:00:00:01,33:33:00,0,58,6,0,0,4110774,4110774,0,1,86,4110774,4110774,0,1,86,0,0,0,0,0,ICMPV6,Network,0,6,,,,,
7780,7780,0,fe80::e1ff:dec7:bebd:f5d0,08:00:27:5e:a3:27,08:00:27,0,ff02::1:ff00:2c6,33:33:ff:00:02:c6,33:33:ff,0,58,6,0,0,4122004,4122280,276,2,172,4122004,4122280,276,2,172,0,0,0,0,0,ICMPV6,Network,0,6,,,,,
7781,7781,0,::,08:00:27:5e:a3:27,08:00:27,0,ff02::1:ff00:2c6,33:33:ff:00:02:c6,33:33:ff,0,58,6,0,0,4122280,4122280,0,1,78,4122280,4122280,0,1,78,0,0,0,0,0,ICMPV6,Network,0,6,,,,,
7782,7782,0,fd2d:ab8c:225::2c6,08:00:27:52:f4:11,08:00:27,0,ff02::1,33:33:00:00:00:01,33:33:00,0,58,6,0,0,4122280,4122280,0,1,86,4122280,4122280,0,1,86,0,0,0,0,0,ICMPV6,Network,0,6,,,,,
7871,7871,0,192.168.1.115,08:00:27:38:31:62,08:00:27,49189,52.207.47.187,1c:6f:65:c0:43:92,1c:6f:65,80,6,4,0,0,4171656,4171656,0,1,54,4171656,4171656,0,1,54,0,0,0,0,0,HTTP,Web,1,1,,,,,
8208,8208,0,fd2d:ab8c:225:0:d165:fe2f:b6b4:4877,08:00:27:5e:a3:27,08:00:27,0,ff02::1:ff00:1,33:33:ff:00:00:01,33:33:ff,0,58,6,0,0,4369760,4369760,0,1,86,4369760,4369760,0,1,86,0,0,0,0,0,ICMPV6,Network,0,6,,,,,
8218,8218,0,fe80::e1ff:dec7:bebd:f5d0,08:00:27:5e:a3:27,08:00:27,0,ff02::1:ff00:f72,33:33:ff:00:0f:72,33:33:ff,0,58,6,0,0,4374775,4374775,0,1,86,4374775,4374775,0,1,86,0,0,0,0,0,ICMPV6,Network,0,6,,,,,
8472,8472,0,::,08:00:27:0a:a9:9c,08:00:27,0,ff02::1:ff76:2c5a,33:33:ff:76:2c:5a,33:33:ff,0,58,6,0,0,4526446,4526446,0,2,156,4526446,4526446,0,2,156,0,0,0,0,0,ICMPV6,Network,0,6,,,,,
8473,8473,0,::,08:00:27:0a:a9:9c,08:00:27,0,ff02::1:ffa6:7837,33:33:ff:a6:78:37,33:33:ff,0,58,6,0,0,4526446,4526446,0,1,78,4526446,4526446,0,1,78,0,0,0,0,0,ICMPV6,Network,0,6,,,,,
8474,8474,0,::,08:00:27:0a:a9:9c,08:00:27,0,ff02::1:ff00:b30,33:33:ff:00:0b:30,33:33:ff,0,58,6,0,0,4526446,4526446,0,1,78,4526446,4526446,0,1,78,0,0,0,0,0,ICMPV6,Network,0,6,,,,,
8475,8475,0,fe80::69b0:5ca7:a676:2c5a,08:00:27:0a:a9:9c,08:00:27,0,ff02::2,33:33:00:00:00:02,33:33:00,0,58,6,0,0,4526446,4534448,8002,5,382,4526446,4534448,8002,5,382,0,0,0,0,0,ICMPV6,Network,0,6,,,,,
8476,8476,0,fd2d:ab8c:225::b30,08:00:27:38:31:62,08:00:27,0,ff02::1,33:33:00:00:00:01,33:33:00,0,58,6,0,0,4526446,4526446,0,1,86,4526446,4526446,0,1,86,0,0,0,0,0,ICMPV6,Network,0,6,,,,,
8477,8477,0,fe80::69b0:5ca7:a676:2c5a,08:00:27:0a:a9:9c,08:00:27,0,ff02::1:ff00:b30,33:33:ff:00:0b:30,33:33:ff,0,58,6,0,0,4526447,4526948,501,2,172,4526447,4526948,501,2,172,0,0,0,0,0,ICMPV6,Network,0,6,,,,,
8478,8478,0,fe80::69b0:5ca7:a676:2c5a,08:00:27:0a:a9:9c,08:00:27,546,ff02::1:2,33:33:00:01:00:02,33:33:00,547,17,6,0,0,4527498,4540027,12529,6,978,4527498,4540027,12529,6,978,0,0,0,0,0,DHCPV6,Network,0,6,,,,,
8484,8484,0,fe80::69b0:5ca7:a676:2c5a,08:00:27:0a:a9:9c,08:00:27,0,ff02::1:ff00:994,33:33:ff:00:09:94,33:33:ff,0,58,6,0,0,4528523,4528950,427,2,172,4528523,4528950,427,2,172,0,0,0,0,0,ICMPV6,Network,0,6,,,,,
8485,8485,0,::,08:00:27:0a:a9:9c,08:00:27,0,ff02::1:ff00:994,33:33:ff:00:09:94,33:33:ff,0,58,6,0,0,4528950,4528950,0,1,78,4528950,4528950,0,1,78,0,0,0,0,0,ICMPV6,Network,0,6,,,,,
8486,8486,0,fd2d:ab8c:225::994,08:00:27:5e:a3:27,08:00:27,0,ff02::1,33:33:00:00:00:01,33:33:00,0,58,6,0,0,4528950,4528950,0,1,86,4528950,4528950,0,1,86,0,0,0,0,0,ICMPV6,Network,0,6,,,,,
8934,8934,0,fd2d:ab8c:225:0:51e6:bfd4:61a6:7837,08:00:27:0a:a9:9c,08:00:27,0,ff02::1:ff00:1,33:33:ff:00:00:01,33:33:ff,0,58,6,0,0,4790917,4790917,0,1,86,4790917,4790917,0,1,86,0,0,0,0,0,ICMPV6,Network,0,6,,,,,
8937,8937,0,192.168.1.117,08:00:27:0a:a9:9c,08:00:27,137,192.168.1.255,ff:ff:ff:ff:ff:ff,ff:ff:ff,137,17,4,0,0,4791217,4792719,1502,3,276,4791217,4792719,1502,3,276,0,0,0,0,0,NetBIOS,System,0,6,wpad,,,,
8947,8947,0,fe80::69b0:5ca7:a676:2c5a,08:00:27:0a:a9:9c,08:00:27,0,ff02::1:ff00:f72,33:33:ff:00:0f:72,33:33:ff,0,58,6,0,0,4795924,4795924,0,1,86,4795924,4795924,0,1,86,0,0,0,0,0,ICMPV6,Network,0,6,,,,,
9319,9319,0,fe80::e8ff:97da:2f7f:abb3,08:00:27:38:31:62,08:00:27,0,ff02::1:ff00:f72,33:33:ff:00:0f:72,33:33:ff,0,58,6,0,0,5002963,5107634,104671,2,172,5002963,5107634,104671,2,172,0,0,0,0,0,ICMPV6,Network,0,6,,,,,
9339,9339,0,fe80::5dd3:6bb3:7720:1e83,08:00:27:52:f4:11,08:00:27,0,ff02::1:ff00:f72,33:33:ff:00:0f:72,33:33:ff,0,58,6,0,0,5011795,5224786,212991,3,258,5011795,5224786,212991,3,258,0,0,0,0,0,ICMPV6,Network,0,6,,,,,
9795,9795,0,::,08:00:27:c3:f9:98,08:00:27,0,ff02::1:ff2b:7a21,33:33:ff:2b:7a:21,33:33:ff,0,58,6,0,0,5264399,5264399,0,2,156,5264399,5264399,0,2,156,0,0,0,0,0,ICMPV6,Network,0,6,,,,,
9796,9796,0,::,08:00:27:c3:f9:98,08:00:27,0,ff02::1:ffba:1f64,33:33:ff:ba:1f:64,33:33:ff,0,58,6,0,0,5264399,5264399,0,1,78,5264399,5264399,0,1,78,0,0,0,0,0,ICMPV6,Network,0,6,,,,,
9797,9797,0,::,08:00:27:c3:f9:98,08:00:27,0,ff02::1:ff00:99e,33:33:ff:00:09:9e,33:33:ff,0,58,6,0,0,5264399,5266903,2504,2,156,5264399,5266903,2504,2,156,0,0,0,0,0,ICMPV6,Network,0,6,,,,,
9798,9798,0,fe80::b504:f453:742b:7a21,08:00:27:c3:f9:98,08:00:27,0,ff02::2,33:33:00:00:00:02,33:33:00,0,58,6,0,0,5264399,5272400,8001,5,382,5264399,5272400,8001,5,382,0,0,0,0,0,ICMPV6,Network,0,6,,,,,
9799,9799,0,fd2d:ab8c:225::99e,08:00:27:0a:a9:9c,08:00:27,0,ff02::1,33:33:00:00:00:01,33:33:00,0,58,6,0,0,5264399,5266903,2504,2,172,5264399,5266903,2504,2,172,0,0,0,0,0,ICMPV6,Network,0,6,,,,,
9800,9800,0,fe80::b504:f453:742b:7a21,08:00:27:c3:f9:98,08:00:27,0,ff02::1:ff00:99e,33:33:ff:00:09:9e,33:33:ff,0,58,6,0,0,5264399,5266903,2504,4,344,5264399,5266903,2504,4,344,0,0,0,0,0,ICMPV6,Network,0,6,,,,,
9805,9805,0,fe80::b504:f453:742b:7a21,08:00:27:c3:f9:98,08:00:27,546,ff02::1:2,33:33:00:01:00:02,33:33:00,547,17,6,0,0,5265430,5277959,12529,6,978,5265430,5277959,12529,6,978,0,0,0,0,0,DHCPV6,Network,0,6,,,,,
9830,9830,0,::,08:00:27:c3:f9:98,08:00:27,0,ff02::1:ff00:fa9,33:33:ff:00:0f:a9,33:33:ff,0,58,6,0,0,5278399,5278399,0,1,78,5278399,5278399,0,1,78,0,0,0,0,0,ICMPV6,Network,0,6,,,,,
9967,9967,0,192.168.1.133,d8:bb:2c:43:01:45,d8:bb:2c,5353,224.0.0.251,01:00:5e:00:00:fb,01:00:5e,5353,17,4,0,0,5352795,5356814,4019,3,336,5352795,5356814,4019,3,336,0,0,0,0,0,MDNS,Network,0,6,_sleep-proxy._udp.local,,,,
10078,10078,0,fd2d:ab8c:225:0:756a:763:45ba:1f64,08:00:27:c3:f9:98,08:00:27,0,ff02::1:ff00:1,33:33:ff:00:00:01,33:33:ff,0,58,6,0,0,5413958,5413958,0,1,86,5413958,5413958,0,1,86,0,0,0,0,0,ICMPV6,Network,0,6,,,,,
10079,10079,0,fe80::b504:f453:742b:7a21,08:00:27:c3:f9:98,08:00:27,53982,ff02::1:3,33:33:00:01:00:03,33:33:00,5355,17,6,0,0,5413959,5414053,94,2,168,5413959,5414053,94,2,168,0,0,0,0,0,LLMNR,Network,0,6,wpad,,,,
10080,10080,0,192.168.1.118,08:00:27:c3:f9:98,08:00:27,59404,224.0.0.252,01:00:5e:00:00:fc,01:00:5e,5355,17,4,0,0,5413959,5414054,95,2,128,5413959,5414054,95,2,128,0,0,0,0,0,LLMNR,Network,0,6,wpad,,,,
10081,10081,0,192.168.1.118,08:00:27:c3:f9:98,08:00:27,137,192.168.1.255,ff:ff:ff:ff:ff:ff,ff:ff:ff,137,17,4,0,0,5414254,5415756,1502,3,276,5414254,5415756,1502,3,276,0,0,0,0,0,NetBIOS,System,0,6,wpad,,,,
10082,10082,0,192.168.1.166,a4:5e:60:dd:58:1d,a4:5e:60,138,192.168.1.255,ff:ff:ff:ff:ff:ff,ff:ff:ff,138,17,4,0,0,5414429,5414429,0,3,648,5414429,5414429,0,3,648,0,0,0,0,0,NetBIOS.SMBv1,System,0,6,macbookpro-581d,,,,
10093,10093,0,fe80::b504:f453:742b:7a21,08:00:27:c3:f9:98,08:00:27,0,ff02::1:ff00:f72,33:33:ff:00:0f:72,33:33:ff,0,58,6,0,0,5418961,5418961,0,1,86,5418961,5418961,0,1,86,0,0,0,0,0,ICMPV6,Network,0,6,,,,,
10115,10115,0,192.168.1.168,f4:f5:d8:45:9f:1a,f4:f5:d8,5353,224.0.0.251,01:00:5e:00:00:fb,01:00:5e,5353,17,4,0,0,5487953,5548576,60623,2,768,5487953,5548576,60623,2,768,0,0,0,0,0,MDNS,Network,0,6,_googlecast._tcp.local,,,,
10118,10118,0,fe80::da58:d7ff:fe00:f72,d8:58:d7:00:0f:72,d8:58:d7,0,ff02::1,33:33:00:00:00:01,33:33:00,0,58,6,0,0,5645103,5645103,0,1,86,5645103,5645103,0,1,86,0,0,0,0,0,ICMPV6,Network,0,6,,,,,
10119,10119,0,fe80::f106:5909:32ae:f4cb,08:00:27:11:4e:fa,08:00:27,0,ff02::1:ff00:4f7,33:33:ff:00:04:f7,33:33:ff,0,58,6,0,0,5645531,5645531,0,1,86,5645531,5645531,0,1,86,0,0,0,0,0,ICMPV6,Network,0,6,,,,,
10120,10120,0,fe80::e1ff:dec7:bebd:f5d0,08:00:27:5e:a3:27,08:00:27,0,ff02::1:ff00:994,33:33:ff:00:09:94,33:33:ff,0,58,6,0,0,5648775,5648775,0,1,86,5648775,5648775,0,1,86,0,0,0,0,0,ICMPV6,Network,0,6,,,,,
10121,10121,0,fe80::b504:f453:742b:7a21,08:00:27:c3:f9:98,08:00:27,0,ff02::1:ff2b:7a21,33:33:ff:2b:7a:21,33:33:ff,0,58,6,0,0,5645406,5645406,0,1,86,5645406,5645406,0,1,86,0,0,0,0,0,ICMPV6,Network,0,6,,,,,
10122,10122,0,fe80::e8ff:97da:2f7f:abb3,08:00:27:38:31:62,08:00:27,0,ff02::1:ff62:aec8,33:33:ff:62:ae:c8,33:33:ff,0,58,6,0,0,5527737,5647239,119502,2,172,5527737,5647239,119502,2,172,0,0,0,0,0,ICMPV6,Network,0,6,,,,,
10123,10123,0,fe80::e1ff:dec7:bebd:f5d0,08:00:27:5e:a3:27,08:00:27,0,ff02::1:ffb4:4877,33:33:ff:b4:48:77,33:33:ff,0,58,6,0,0,5649276,5649276,0,1,86,5649276,5649276,0,1,86,0,0,0,0,0,ICMPV6,Network,0,6,,,,,
10124,10124,0,fe80::b504:f453:742b:7a21,08:00:27:c3:f9:98,08:00:27,0,ff02::1:ff00:fa9,33:33:ff:00:0f:a9,33:33:ff,0,58,6,0,0,5527907,5647399,119492,2,172,5527907,5647399,119492,2,172,0,0,0,0,0,ICMPV6,Network,0,6,,,,,
10125,10125,0,fe80::f106:5909:32ae:f4cb,08:00:27:11:4e:fa,08:00:27,0,ff02::1:ffcc:1f02,33:33:ff:cc:1f:02,33:33:ff,0,58,6,0,0,5645530,5645530,0,1,86,5645530,5645530,0,1,86,0,0,0,0,0,ICMPV6,Network,0,6,,,,,
10127,10127,0,fe80::e1ff:dec7:bebd:f5d0,08:00:27:5e:a3:27,08:00:27,0,ff02::1:ffbd:f5d0,33:33:ff:bd:f5:d0,33:33:ff,0,58,6,0,0,5654273,5654273,0,1,86,5654273,5654273,0,1,86,0,0,0,0,0,ICMPV6,Network,0,6,,,,,
10129,10129,0,fe80::5dd3:6bb3:7720:1e83,08:00:27:52:f4:11,08:00:27,0,ff02::1:ff2b:5398,33:33:ff:2b:53:98,33:33:ff,0,58,6,0,0,5650637,5650637,0,1,86,5650637,5650637,0,1,86,0,0,0,0,0,ICMPV6,Network,0,6,,,,,
10130,10130,0,fe80::5dd3:6bb3:7720:1e83,08:00:27:52:f4:11,08:00:27,0,ff02::1:ff00:2c6,33:33:ff:00:02:c6,33:33:ff,0,58,6,0,0,5652139,5652139,0,1,86,5652139,5652139,0,1,86,0,0,0,0,0,ICMPV6,Network,0,6,,,,,
10131,10131,0,fe80::e8ff:97da:2f7f:abb3,08:00:27:38:31:62,08:00:27,0,ff02::1:ff00:b30,33:33:ff:00:0b:30,33:33:ff,0,58,6,0,0,5646238,5646238,0,1,86,5646238,5646238,0,1,86,0,0,0,0,0,ICMPV6,Network,0,6,,,,,
10132,10132,0,fe80::69b0:5ca7:a676:2c5a,08:00:27:0a:a9:9c,08:00:27,0,ff02::1:ff00:99e,33:33:ff:00:09:9e,33:33:ff,0,58,6,0,0,5648449,5648449,0,1,86,5648449,5648449,0,1,86,0,0,0,0,0,ICMPV6,Network,0,6,,,,,
10133,10133,0,fe80::69b0:5ca7:a676:2c5a,08:00:27:0a:a9:9c,08:00:27,0,ff02::1:ff76:2c5a,33:33:ff:76:2c:5a,33:33:ff,0,58,6,0,0,5652946,5652946,0,1,86,5652946,5652946,0,1,86,0,0,0,0,0,ICMPV6,Network,0,6,,,,,
10134,10134,0,fe80::f106:5909:32ae:f4cb,08:00:27:11:4e:fa,08:00:27,0,ff02::1:ffae:f4cb,33:33:ff:ae:f4:cb,33:33:ff,0,58,6,0,0,5650528,5650528,0,1,86,5650528,5650528,0,1,86,0,0,0,0,0,ICMPV6,Network,0,6,,,,,
10135,10135,0,fe80::5dd3:6bb3:7720:1e83,08:00:27:52:f4:11,08:00:27,0,ff02::1:ff20:1e83,33:33:ff:20:1e:83,33:33:ff,0,58,6,0,0,5646141,5646141,0,1,86,5646141,5646141,0,1,86,0,0,0,0,0,ICMPV6,Network,0,6,,,,,
10136,10136,0,fe80::69b0:5ca7:a676:2c5a,08:00:27:0a:a9:9c,08:00:27,0,ff02::1:ffa6:7837,33:33:ff:a6:78:37,33:33:ff,0,58,6,0,0,5653947,5653947,0,1,86,5653947,5653947,0,1,86,0,0,0,0,0,ICMPV6,Network,0,6,,,,,
10141,10141,0,fe80::e8ff:97da:2f7f:abb3,08:00:27:38:31:62,08:00:27,0,ff02::1:ff62:aec8,33:33:ff:62:ae:c8,33:33:ff,0,58,6,0,0,5772238,5772238,0,1,86,5772238,5772238,0,1,86,0,0,0,0,0,ICMPV6,Network,0,6,,,,,
10142,10142,0,fe80::e1ff:dec7:bebd:f5d0,08:00:27:5e:a3:27,08:00:27,0,ff02::1:ff00:994,33:33:ff:00:09:94,33:33:ff,0,58,6,0,0,5771781,5771781,0,1,86,5771781,5771781,0,1,86,0,0,0,0,0,ICMPV6,Network,0,6,,,,,
10143,10143,0,fe80::b504:f453:742b:7a21,08:00:27:c3:f9:98,08:00:27,0,ff02::1:ff2b:7a21,33:33:ff:2b:7a:21,33:33:ff,0,58,6,0,0,5771908,5771908,0,1,86,5771908,5771908,0,1,86,0,0,0,0,0,ICMPV6,Network,0,6,,,,,
10144,10144,0,fe80::f106:5909:32ae:f4cb,08:00:27:11:4e:fa,08:00:27,0,ff02::1:ff00:4f7,33:33:ff:00:04:f7,33:33:ff,0,58,6,0,0,5771031,5771031,0,1,86,5771031,5771031,0,1,86,0,0,0,0,0,ICMPV6,Network,0,6,,,,,
10145,10145,0,fe80::69b0:5ca7:a676:2c5a,08:00:27:0a:a9:9c,08:00:27,0,ff02::1:ff76:2c5a,33:33:ff:76:2c:5a,33:33:ff,0,58,6,0,0,5778947,5778947,0,1,86,5778947,5778947,0,1,86,0,0,0,0,0,ICMPV6,Network,0,6,,,,,
10146,10146,0,fe80::5dd3:6bb3:7720:1e83,08:00:27:52:f4:11,08:00:27,0,ff02::1:ff2b:5398,33:33:ff:2b:53:98,33:33:ff,0,58,6,0,0,5778140,5778140,0,1,86,5778140,5778140,0,1,86,0,0,0,0,0,ICMPV6,Network,0,6,,,,,
10147,10147,0,fe80::5dd3:6bb3:7720:1e83,08:00:27:52:f4:11,08:00:27,0,ff02::1:ff00:2c6,33:33:ff:00:02:c6,33:33:ff,0,58,6,0,0,5778140,5778140,0,1,86,5778140,5778140,0,1,86,0,0,0,0,0,ICMPV6,Network,0,6,,,,,
10148,10148,0,fe80::b504:f453:742b:7a21,08:00:27:c3:f9:98,08:00:27,0,ff02::1:ffba:1f64,33:33:ff:ba:1f:64,33:33:ff,0,58,6,0,0,5653408,5772900,119492,2,172,5653408,5772900,119492,2,172,0,0,0,0,0,ICMPV6,Network,0,6,,,,,
10149,10149,0,fe80::69b0:5ca7:a676:2c5a,08:00:27:0a:a9:9c,08:00:27,0,ff02::1:ff00:99e,33:33:ff:00:09:9e,33:33:ff,0,58,6,0,0,5778446,5778446,0,1,86,5778446,5778446,0,1,86,0,0,0,0,0,ICMPV6,Network,0,6,,,,,
10150,10150,0,fe80::e1ff:dec7:bebd:f5d0,08:00:27:5e:a3:27,08:00:27,0,ff02::1:ffb4:4877,33:33:ff:b4:48:77,33:33:ff,0,58,6,0,0,5772272,5772272,0,1,86,5772272,5772272,0,1,86,0,0,0,0,0,ICMPV6,Network,0,6,,,,,
10151,10151,0,fe80::69b0:5ca7:a676:2c5a,08:00:27:0a:a9:9c,08:00:27,0,ff02::1:ffa6:7837,33:33:ff:a6:78:37,33:33:ff,0,58,6,0,0,5779949,5779949,0,1,86,5779949,5779949,0,1,86,0,0,0,0,0,ICMPV6,Network,0,6,,,,,
10152,10152,0,fe80::f106:5909:32ae:f4cb,08:00:27:11:4e:fa,08:00:27,0,ff02::1:ffae:f4cb,33:33:ff:ae:f4:cb,33:33:ff,0,58,6,0,0,5779023,5779023,0,1,86,5779023,5779023,0,1,86,0,0,0,0,0,ICMPV6,Network,0,6,,,,,
10153,10153,0,fe80::5dd3:6bb3:7720:1e83,08:00:27:52:f4:11,08:00:27,0,ff02::1:ff20:1e83,33:33:ff:20:1e:83,33:33:ff,0,58,6,0,0,5779643,5779643,0,1,86,5779643,5779643,0,1,86,0,0,0,0,0,ICMPV6,Network,0,6,,,,,
10154,10154,0,fe80::f106:5909:32ae:f4cb,08:00:27:11:4e:fa,08:00:27,0,ff02::1:ffcc:1f02,33:33:ff:cc:1f:02,33:33:ff,0,58,6,0,0,5773525,5773525,0,1,86,5773525,5773525,0,1,86,0,0,0,0,0,ICMPV6,Network,0,6,,,,,
10155,10155,0,fe80::b504:f453:742b:7a21,08:00:27:c3:f9:98,08:00:27,0,ff02::1:ff00:fa9,33:33:ff:00:0f:a9,33:33:ff,0,58,6,0,0,5773400,5773400,0,1,86,5773400,5773400,0,1,86,0,0,0,0,0,ICMPV6,Network,0,6,,,,,
10156,10156,0,fe80::e8ff:97da:2f7f:abb3,08:00:27:38:31:62,08:00:27,0,ff02::1:ff00:b30,33:33:ff:00:0b:30,33:33:ff,0,58,6,0,0,5778237,5778237,0,1,86,5778237,5778237,0,1,86,0,0,0,0,0,ICMPV6,Network,0,6,,,,,
10157,10157,0,fe80::e8ff:97da:2f7f:abb3,08:00:27:38:31:62,08:00:27,0,ff02::1:ff7f:abb3,33:33:ff:7f:ab:b3,33:33:ff,0,58,6,0,0,5652737,5771238,118501,2,172,5652737,5771238,118501,2,172,0,0,0,0,0,ICMPV6,Network,0,6,,,,,
10165,10165,0,fe80::da58:d7ff:fe00:f72,d8:58:d7:00:0f:72,d8:58:d7,0,ff02::1,33:33:00:00:00:01,33:33:00,0,58,6,0,0,5770543,5895982,125439,3,370,5770543,5895982,125439,3,370,0,0,0,0,0,ICMPV6,Network,0,6,,,,,
10166,10166,0,fe80::69b0:5ca7:a676:2c5a,08:00:27:0a:a9:9c,08:00:27,0,ff02::1:ff76:2c5a,33:33:ff:76:2c:5a,33:33:ff,0,58,6,0,0,5898950,5898950,0,1,86,5898950,5898950,0,1,86,0,0,0,0,0,ICMPV6,Network,0,6,,,,,
10167,10167,0,fe80::e1ff:dec7:bebd:f5d0,08:00:27:5e:a3:27,08:00:27,0,ff02::1:ffb4:4877,33:33:ff:b4:48:77,33:33:ff,0,58,6,0,0,5900778,5900778,0,1,86,5900778,5900778,0,1,86,0,0,0,0,0,ICMPV6,Network,0,6,,,,,
10168,10168,0,fe80::e8ff:97da:2f7f:abb3,08:00:27:38:31:62,08:00:27,0,ff02::1:ff62:aec8,33:33:ff:62:ae:c8,33:33:ff,0,58,6,0,0,5896237,5896237,0,1,86,5896237,5896237,0,1,86,0,0,0,0,0,ICMPV6,Network,0,6,,,,,
10169,10169,0,fe80::b504:f453:742b:7a21,08:00:27:c3:f9:98,08:00:27,0,ff02::1:ff2b:7a21,33:33:ff:2b:7a:21,33:33:ff,0,58,6,0,0,5896407,5896407,0,1,86,5896407,5896407,0,1,86,0,0,0,0,0,ICMPV6,Network,0,6,,,,,
10170,10170,0,fe80::f106:5909:32ae:f4cb,08:00:27:11:4e:fa,08:00:27,0,ff02::1:ffcc:1f02,33:33:ff:cc:1f:02,33:33:ff,0,58,6,0,0,5902029,5902029,0,1,86,5902029,5902029,0,1,86,0,0,0,0,0,ICMPV6,Network,0,6,,,,,
10171,10171,0,fe80::b504:f453:742b:7a21,08:00:27:c3:f9:98,08:00:27,0,ff02::1:ffba:1f64,33:33:ff:ba:1f:64,33:33:ff,0,58,6,0,0,5899902,5899902,0,1,86,5899902,5899902,0,1,86,0,0,0,0,0,ICMPV6,Network,0,6,,,,,
10172,10172,0,fe80::5dd3:6bb3:7720:1e83,08:00:27:52:f4:11,08:00:27,0,ff02::1:ff2b:5398,33:33:ff:2b:53:98,33:33:ff,0,58,6,0,0,5899134,5899134,0,1,86,5899134,5899134,0,1,86,0,0,0,0,0,ICMPV6,Network,0,6,,,,,
10173,10173,0,fe80::5dd3:6bb3:7720:1e83,08:00:27:52:f4:11,08:00:27,0,ff02::1:ff00:2c6,33:33:ff:00:02:c6,33:33:ff,0,58,6,0,0,5899635,5899635,0,1,86,5899635,5899635,0,1,86,0,0,0,0,0,ICMPV6,Network,0,6,,,,,
10174,10174,0,fe80::69b0:5ca7:a676:2c5a,08:00:27:0a:a9:9c,08:00:27,0,ff02::1:ffa6:7837,33:33:ff:a6:78:37,33:33:ff,0,58,6,0,0,5900952,5900952,0,1,86,5900952,5900952,0,1,86,0,0,0,0,0,ICMPV6,Network,0,6,,,,,
10175,10175,0,fe80::f106:5909:32ae:f4cb,08:00:27:11:4e:fa,08:00:27,0,ff02::1:ff00:4f7,33:33:ff:00:04:f7,33:33:ff,0,58,6,0,0,5897022,5897022,0,1,86,5897022,5897022,0,1,86,0,0,0,0,0,ICMPV6,Network,0,6,,,,,
10176,10176,0,fe80::e1ff:dec7:bebd:f5d0,08:00:27:5e:a3:27,08:00:27,0,ff02::1:ff00:994,33:33:ff:00:09:94,33:33:ff,0,58,6,0,0,5896281,5896281,0,1,86,5896281,5896281,0,1,86,0,0,0,0,0,ICMPV6,Network,0,6,,,,,
10177,10177,0,fe80::e8ff:97da:2f7f:abb3,08:00:27:38:31:62,08:00:27,0,ff02::1:ff7f:abb3,33:33:ff:7f:ab:b3,33:33:ff,0,58,6,0,0,5905731,5905731,0,1,86,5905731,5905731,0,1,86,0,0,0,0,0,ICMPV6,Network,0,6,,,,,
10178,10178,0,fe80::f106:5909:32ae:f4cb,08:00:27:11:4e:fa,08:00:27,0,ff02::1:ffae:f4cb,33:33:ff:ae:f4:cb,33:33:ff,0,58,6,0,0,5901028,5901028,0,1,86,5901028,5901028,0,1,86,0,0,0,0,0,ICMPV6,Network,0,6,,,,,
10179,10179,0,fe80::e1ff:dec7:bebd:f5d0,08:00:27:5e:a3:27,08:00:27,0,ff02::1:ffbd:f5d0,33:33:ff:bd:f5:d0,33:33:ff,0,58,6,0,0,5777780,5897282,119502,2,172,5777780,5897282,119502,2,172,0,0,0,0,0,ICMPV6,Network,0,6,,,,,
10180,10180,0,fe80::5dd3:6bb3:7720:1e83,08:00:27:52:f4:11,08:00:27,0,ff02::1:ff20:1e83,33:33:ff:20:1e:83,33:33:ff,0,58,6,0,0,5901137,5901137,0,1,86,5901137,5901137,0,1,86,0,0,0,0,0,ICMPV6,Network,0,6,,,,,
10181,10181,0,fe80::69b0:5ca7:a676:2c5a,08:00:27:0a:a9:9c,08:00:27,0,ff02::1:ff00:99e,33:33:ff:00:09:9e,33:33:ff,0,58,6,0,0,5899951,5899951,0,1,86,5899951,5899951,0,1,86,0,0,0,0,0,ICMPV6,Network,0,6,,,,,
10197,10197,0,fe80::b504:f453:742b:7a21,08:00:27:c3:f9:98,08:00:27,0,ff02::1:ff00:fa9,33:33:ff:00:0f:a9,33:33:ff,0,58,6,0,0,5903908,6023900,119992,2,172,5903908,6023900,119992,2,172,0,0,0,0,0,ICMPV6,Network,0,6,,,,,
10199,10199,0,fe80::e8ff:97da:2f7f:abb3,08:00:27:38:31:62,08:00:27,0,ff02::1:ff00:b30,33:33:ff:00:0b:30,33:33:ff,0,58,6,0,0,5904238,6023780,119542,2,172,5904238,6023780,119542,2,172,0,0,0,0,0,ICMPV6,Network,0,6,,,,,
10218,10218,0,192.168.1.166,a4:5e:60:dd:58:1d,a4:5e:60,138,192.168.1.255,ff:ff:ff:ff:ff:ff,ff:ff:ff,138,17,4,0,0,5948746,5948746,0,2,432,5948746,5948746,0,2,432,0,0,0,0,0,NetBIOS.SMBv1,System,0,6,macbookpro-581d,,,,
10373,10373,0,192.168.1.133,d8:bb:2c:43:01:45,d8:bb:2c,5353,224.0.0.251,01:00:5e:00:00:fb,01:00:5e,5353,17,4,0,0,5747686,5916837,169151,12,1344,5747686,5916837,169151,12,1344,0,0,0,0,0,MDNS,Network,0,6,_sleep-proxy._udp.local,,,,
10468,10468,0,fe80::e8ff:97da:2f7f:abb3,08:00:27:38:31:62,08:00:27,0,ff02::1:ff00:f72,33:33:ff:00:0f:72,33:33:ff,0,58,6,0,0,5900878,5900878,0,1,86,5900878,5900878,0,1,86,0,0,0,0,0,ICMPV6,Network,0,6,,,,,
10478,10478,0,fe80::5dd3:6bb3:7720:1e83,08:00:27:52:f4:11,08:00:27,0,ff02::1:ff00:f72,33:33:ff:00:0f:72,33:33:ff,0,58,6,0,0,5917742,6030574,112832,2,172,5917742,6030574,112832,2,172,0,0,0,0,0,ICMPV6,Network,0,6,,,,,
11345,11345,0,fe80::f106:5909:32ae:f4cb,08:00:27:11:4e:fa,08:00:27,0,ff02::1:ff00:f72,33:33:ff:00:0f:72,33:33:ff,0,58,6,0,0,5881807,5881807,0,1,86,5881807,5881807,0,1,86,0,0,0,0,0,ICMPV6,Network,0,6,,,,,
